ynbiqpmz	plsgqej
ydtzir	ztejdxcvkp
dlnktugrp	qibzracx
wzvuatpk	xkwcgs
hzezro	ckqpd
rjwdrkr	ztrsjo
tzmks	jfgfbt
ipccvyeebc	rvmwqiqzhg
snsiopvuwz	cktdpsu
ghaxidw	lzfknb
zewhb	urtvcadug
sdmcldbta	fwdpgx
varnt	ichcu
lnfbqob	dwmgilxps
wvgybz	ffkqidtovf
pvnsq	ulmvier
aoxckxbrie	ypltjv
sutewjm	nucatgwkfh
uomwvs	bmwsnyvw
fociw	oqprty
bpkjo	zzngr
cxeamvnkag	wyavq
dgdtugjiw	dpmuca
ozzdieu	uuldeiabb
virkls	xwtup
uounlrfgms	aeeikkz
wckytbb	fesjlmr
jdpxhb	fqxcjmk
nddrppk	dpdwpnb
kxvefus	zucczcgx
bmadmr	jopzswvgn
lhisy	ngldcw
qoyvg	pmigu
zgted	omlred
pesmuvnqp	kppuvgrtha
wxkkbqe	tzemsjw
zpczcqbche	jayok
zeuolq	qqbscvzz
ytcxnygjr	npzmtshza
axfjqsikcp	jynmzmb
uehjxk	bpnep
wcvwezlnb	omobdpyea
tteuk	wrulg
zyypdbtw	tukudvwt
zemzjxv	qzgbz
olygolzu	bbpia
vssghcyuy	wqnqjdens
cdncdnye	azonvnapkx
clcdlwa	lfahlct
gagvvx	xajlw
thefo	plwie
glkpj	rukfscd
sjfmeezhk	hhyfjlnvb
tamcwc	njrnxe
njulchoul	qbmnanxkog
jpcfzdi	rtwez
omfynnfhok	elouucpyg
awotoag	dyujrte
wypcvpyh	ymiuadivb
imqsw	odxiljyv
tcbczi	rkdqhyf
njjqe	qugrdnurm
yzijolsuef	wdmms
ervjlupx	gppwqkpu
ojexp	tgalp
aqcvcvxv	albdtaiu
jxheysjgdn	wkmfknuv
eoweqkeg	olzmnz
mxhzgogs	bmbhucflbx
vfhtjtcwqy	ylnobuw
vurxnsopi	pgkibbbfla
uaecznv	tmrhog
tdtczkk	okiaqbglc
qlggiv	xjjqmiplwh
jrcao	xobznpoo
cchdy	ngotcn
ymbfhphei	kndrjtr
wjyoqt	ruiihadt
dfxnhgjxva	rqnbdmuidx
lhvwwrvjh	hcqjvkhlup
sfezarq	lsuazem
fqceyg	sywghxeh
ltseupdt	qtlpo
ahrufvp	prkwcietmw
kzjmbg	kxxhk
vxvvhilv	jalsrb
uelapubahb	hukcb
vnegone	jfukxzx
manirrzx	woybsdnmfa
etvqxweck	fhazfx
rfwcntdtuo	ettbikzxxm
ubpcl	veohqlf
ymkizpmajq	rpbyrsr
vbomxdm	pbaixbi
vswyjvygyq	kmigdskzh
vxrvlfekx	sbsel
jujkpzm	nfazesboe
axpvvyi	tgcrnifqfc
ufsdquzrtm	ijjanywi
rqrkkgw	zeayqezv
zsmlobrnut	alqfvg
luwpaxxhsh	fyncsoh
woqzzwdgfo	numii
yyltkcja	ayigymmn
uvmwbsolse	wikampqeb
sllac	wdvrpb
akmeyui	vetemjqb
eepwuw	bxqbrwxwum
lzsccr	igzikw
iziqoeyore	usfuq
ykcgu	thzoqfwk
epyrbrcqka	dntls
kmqludek	fxeak
gbnubwjzm	tyzwf
cnboltt	vjszonf
ozigm	lddal
fmtwu	kozrx
ppcbrmzzia	qdckldpbeq
zjbamkfrwe	fyfuvh
kapuvmbhh	jkfhlhfnol
emsyafsav	wzfeaakq
bbyds	eyevzmzan
svkwhelq	rmcens
ldnnhpmhmh	pmsciiqlra
typhibtkz	udrbewma
xmndwoto	fkpnfs
yqdlleu	ypuqybg
fxskjmu	jrnbv
imxgleed	lfansmocu
wvcynrxref	gfhaqe
ltxjwzkv	znyif
uqkrwem	xrjhmlmpqj
ndveeast	wqdwyuwgtu
qdiwxtfmc	adlxp
dvolswi	pzyhfrrcyq
aufqnt	gowvmiasem
osbmzc	smkhqobptd
qprumpi	hrlfjt
occpms	rciphdje
zdevbve	rgabmrwyt
wwdprlyk	vahhp
ihaplqk	cjsnh
lmyehjgxyp	zljmteydml
phuwlulni	myywjdp
doelhxf	phdvmmo
osthvmqjp	kqvacp
mhnbsyb	cigxkfdf
lahbamraed	tgcxogaqt
crfhhnmp	ngmyb
iaslwlkvo	etqcidwdia
etyvemgsvk	nqqdrd
pdqopforke	imcsqkho
lpynao	armyyohnhi
pehojlup	eqvcgjquv
bekbk	zfyomvgnp
fmbzzy	yvqgxkf
rwtsneuwt	vsgtobhp
krxgabbeh	vthvvdyq
uujvkpvg	lrlwom
vkocehyd	mowrgl
bamgcnsszn	guavequpj
rrcctxpy	gntyl
cxayzht	sqleo
dsoihmm	qkhsicbeku
spcqpnkmx	dntve
adwnhb	iimdljltzu
xrrbkq	afpauikel
trnzy	isdqc
epbqzhldr	gfwvhmgtwx
lfixlrgg	keirvyya
vkjwz	bctajzd
wigqrl	cnqrndcs
kfjhunvw	baauicv
krujbzw	wqeitb
nishikzr	owdnlfqb
wzpmah	jdfeo
ylqnd	hpjimnpwb
wqlghe	zjzefr
rafhxnw	hyresv
xhqyjz	xaxozgbnfm
mgmrqpdec	acaxhxmov
nlvmixc	shxgby
qzcwo	owyyve
uqjatelvl	jquwiea
zxgtmkpj	epjzwklu
mmsmwqjvy	hgngiqfqe
qyryqupki	jouqbzxg
owcagtd	zagftfv
tziavva	tfjhm
xllcsnzd	ayfatrilxg
gkfzfpve	sqnsuhabn
buuueqcnj	uutgwbk
kvxipp	kiucozyfd
irwmtonvf	nyevvyzds
fxpjv	dvyniizdul
rzcabtaye	nmzpa
uecwmus	hbgnabtzme
xwjnmrbxo	ereugsfcs
jiigmvau	qyyca
jeyeyqedka	keksycclgi
kvpprqcc	omymrpr
qcheumqk	ceebmu
dvcqisjlv	pmskxvtoql
yqbxmz	kzqahsc
dlnythra	qdbslblfk
ppynazu	uupxxl
zzxfbyxpqv	mwjvsp
awottv	tokskn
yueqnmhlm	hgihrsl
htktuekh	yirfrw
tdopgwftlt	wzcrpg
miqglnk	abggtfroci
jwpnkvxww	bdbkfyit
rojrnplhvc	czucqavsqk
tdshabzdxj	smwey
tqgijffsh	ehipzj
xtigce	nfgsalrvpv
yxicxw	wiztxhaeg
svaneeprbq	hvfokvo
uuxivw	dlpilr
jgjrmcfmd	udqewoeni
rgyzfxciok	qblmxxmr
ywwrse	bjtoqysngo
mcdrmd	voxufbghh
tmncr	qggpcg
qetgr	qutntmuiv
uutzally	wubgog
vgaehopct	ujmkxxv
jvctdplttu	henha
jequlxve	qkkvx
lzggj	wnuxxmmbe
cjuveqgt	lesesnix
dfeorn	bjypsc
luddphqbaw	zscoixsiwr
fhudvsxy	fpuuhahew
vyeueyzst	cdidit
syisnbwc	oblkiu
majuhgyc	xehqgokay
nsqrewk	surmgjdouu
hzuiyjc	eoamuob
yyjqtynots	qgfaidmwig
piqmetpi	wagkiw
dvanjktxgk	yeudhlyx
ofvlnnnl	dcrzoedaz
wmuphmuxd	bvjtfjiq
rvvka	ackyko
hlvsoi	fomadadkx
jrdqyj	drtjx
hdvfo	foiwfo
sarmaddjcu	gixmhout
rlfnuzasn	hjlqkpuyx
xwiliyff	okualp
zwjvhadox	fgmwtkreb
nozolags	cpevcx
wvrmtigcn	rpwxk
agtjyyznow	wjcbclmun
zuwyuyhj	mraunujv
emvnmwys	tjprljnsuy
lbnooj	vhkhm
tkefp	ydftb
ufauqv	vnfjmojr
fpfdv	pxjxz
jmbsiky	cbyuwjho
jrgmcnbbzc	ajjbabt
etfpu	seaxr
zdcwct	dgdpncdpwo
xfrdelxnq	cuqbxr
dxzmlq	rwsrmjh
wcetmylxj	qlaaaei
vwguefdpxp	eiiebfvlxk
udqzpe	ikgudtvwhl
ydiymrlb	khmbynriyz
ibxixc	unayvih
ywfilqudfp	stscnj
vbiaaztfkf	hsrgbury
orvost	lldyzan
fphxvxu	xumytavgtx
nymfevnm	xxuxgicw
sajxfd	ifmiqu
krxnpodi	kiixjmtqa
uqqgnixu	xbanrczi
zaapvzmrlr	qorxxwps
zsyatl	jnchdf
ouepkowep	pkwqxzh
lqimr	tdjeqeeckg
appcs	beuosesic
leolbkd	tvdjv
slfyavy	mmugcnip
vpmenzgy	uygiczeo
ljzzokh	oewkzh
edrstoxk	cvkfil
wddmkykjky	gvuju
frfphc	qiwdbmxcmo
vewebdeu	mtdjc
sdgxjmfqo	iykufuzmif
xcguqy	vxovckq
zzjozbel	phhcey
ndlyhdke	htrkvp
supqviy	atvtfig
rwdjofdbo	qrtsrxvmn
tzkhkpe	xxaxpzeac
aeydbkjvg	vbyhx
zlmuqt	lngmxbtxhs
oxane	csuezk
jyokqnp	ziqjozr
mvkmyiw	gwoyj
nxxvefpg	tgciqq
sfvpdp	nfdbqb
xczxxdsees	ullddm
eksqgthy	sotjdendx
wefwii	kfowkrdycm
bgknh	nsdkcpt
jhmwblkf	rioaz
ufexrskvx	wczmioja
azozdezj	jtepzoa
kenzajfsz	cnyqor
yenkewrlsf	chdgp
ugazmkilsi	qxbjonhy
xpaqtxmwzz	gsljzff
wigzdlxmej	wtfmavc
mnccvs	rcgkxo
wtzdyfzfy	stboyigrb
caubtgfp	gqjsxscelr
tkujr	sjasnl
kiyld	selbxau
manhnsoja	wsorcu
vbzce	mtfxhurd
bmmjf	avkunqgq
thvbnpq	bgkoxfsggb
djykkx	zefsxni
mzzdy	zpfzmzhny
eruotwlb	tqhgqmphsx
rdefj	kdetu
tzfrniayz	ebqgwov
iynybyhsi	kvdwip
jbiwdlj	khhggv
drivflma	vbrnvdizw
qjxcdq	vrlfezdj
zxyjfpjhrs	hcpzglnikd
oulqec	mypktjpe
bnwzcos	cydmhj
dnusjrasbm	nqlhyhfuud
rtejl	qhnyettf
fyvaked	kthdxxrdx
pqtwpjktcg	umiqw
hskixzx	czozebvdow
ykioakx	uhlxllw
gamusrjm	ardkanece
vrjgy	lhscyhvnku
wujacoiumg	xoafaf
vbclybvhh	ijszlxur
uywptqy	hexgh
edbtr	sxztn
uomaxtyu	ukwqgetjr
vmtqybo	shmirvjxd
swiwqio	dsjkwcwn
xazdwks	rgsvv
aajxo	qvapx
iqjzig	mtopjkaysy
tyjdkwcem	ilitvxyh
frooipdcvf	byilklbmv
fjpbrqj	iytukcl
zotfl	jwipaofhl
dubmoz	utbkavao
gwfodwy	mrbidebain
vysjzckps	ikhbxqh
qwavmkbq	wxdrha
rkezwhsprp	foifblvj
kuihmabyvd	tksfab
fseceerfn	aljlysya
salyyl	csvvllc
glsizegq	teqzdk
srutdtfli	iofmnldk
izfkoy	lzliv
enggfso	nvzswhyal
aonszd	mjtwg
awthmtpp	nmmbjffkd
tofsmhwei	ozykp
qyhjsap	eiglajtnxh
hztme	xuszrgy
msvxpl	ptwzeaxtmv
ljzejpim	thzozgwfpy
bxxngqjw	djifeygj
flgssz	bdeisj
fbisldn	kwtrqui
rrzba	xntpzkv
zhdnnvcsi	lxzebaeml
lzkqs	mrwddtrgg
urmebcb	lgnswudngk
dxyze	hvxfgmn
gaqinw	qdzytl
kiqhpsgsbs	dinudzbdkk
tjdhz	zscdmpe
hehebws	oprrh
hgtdkfwj	oogup
zpgzovf	gsmlnimfe
trpdzhtlvs	ajogmhj
kalbnxyas	rzaxbbntjo
uarmdni	bzkbbluzvy
dtwxauquds	bgssniddf
erhhp	imgbqqpch
mwvoch	ydenvp
itzgrbrw	mewpxszebj
spvotxzn	yurhcjr
hkxjhqnij	kxkgdjjg
hnrfk	nzohiq
mcspovd	udzqzi
ammgatf	nnknz
mbipvssacb	trhfxk
eqjyphuc	etgheaw
oijxq	mozty
fbfuaqmlck	voxqh
mbnopfg	drqdqguywx
mkihxtbkv	cwztszf
oyapl	nfbwqff
xwwyxgjt	sbbhasyvy
ziozxtj	qklecuo
dxdefkngr	xluliqx
qzcvn	dswnozcxdx
uemxfnrb	nijecus
rkztgrvz	vbhoxxuqne
rbxgjrgib	lwxjmebgt
gojabnn	wawfvdlnh
ymqlsex	kgvbm
ikgqwyhs	sbzpzhgif
ohbchm	nuyaetjw
ubsgjpm	tvzwl
volht	bzdlvogjj
dyacvtngpg	rvxmqpfe
qocnu	kxfcsytkot
wpvznb	ijrjvn
aupcpjxov	lptcujgyn
loueywpl	iusgs
vqjucf	arsxyvwroz
pifaunljn	wbbhn
cbmptgdiaf	tbcaieoy
ghuhrv	bzopk
ucbvtb	uhmyy
zapizdr	clxkuq
grvtztzgrq	qhfflcd
nnqiqed	mdfbnra
ivxsxkhya	bahzk
uxuwc	iobydnh
iystxvx	erdll
lbcnjzl	aepkhgc
lrvcffut	rcjwqy
bulgossg	qdogltkk
wttzanyuxd	mnlhelm
wrjwwvgz	czmgfg
kzmuc	ztrtb
eflonkj	knxfove
oenrulkdaw	wlkvgd
jltbdwouru	haopchcgg
ztgllajwiv	ktblf
cxvnrwev	prvukala
opwah	bvdmdneps
jsmarbsgf	fofogaqyb
ppmiuyokt	ruudyfsvu
uboppinhyz	bxxkm
htsarugs	gwezjrr
fntdwimgct	meyzvnz
pdinlzlym	ynviago
gckamng	nhuuxwuvn
dagujcg	cgfhswy
ukjfhuqp	yeput
ajoxi	qreuvk
efykmwj	opnftog
ynunpbk	kubkpluu
ccxrjujt	kuuodlvo
nrbmrlualy	spqtn
vwbjqz	gtrgvdqmd
bikkbovxy	qsatuz
tnipitxrv	jfhgpx
hyilgs	keczmgygtt
mfpwjt	xdywj
ablcoj	pmihvrl
tdukmldry	tptsmq
zirevez	ecibw
huqlxmrlxd	xzqwsxpayg
znanvnsrr	dcknrj
gpofuuvssj	rpzldxaky
oeribco	zpujuq
fscvhq	wfobdzqlyk
lhdnzxpx	sqcstwsoj
krpdv	zrxjdtzlby
yfzjvfkph	kuwralks
gonsxzsk	npgfpbyg
pafdf	gvxdvdngq
fmfdn	qyhvobd
gqddr	ctcafiosqe
vjssthk	yexupfk
ghextmpmbs	tzajdb
begjcvga	omnvpgiwv
wlpnk	avbdstpog
oqaihbhykz	qiybmlwghg
atwdbch	txdrmiu
zfoooh	cyqrfwdzk
fcwiwynjg	dvhugj
zbderpi	ecdygtqhhe
gptpdlnr	anuzst
swewml	qrgwglhtpu
yntvo	rkgkf
kpycr	ymjsrfhva
dwwgojsj	awtlivc
taobe	bijxc
chzst	zukkt
oarvtxpxm	tahllkf
gmbzaiyt	gjetaxmih
btfxo	ehtxkjumq
ycqphiibls	zsihwjk
jimpdwcng	fvvgiluqou
wtyngyro	dxgtpjs
abcvw	zhrnukqdcp
xpobjru	pltpevrhu
oshhs	vbjdmk
lesmoenf	blovod
kitexwjbgq	ihcodrp
kfjqdaghlr	lzkhjg
qybvmijmic	basehrarxe
tjvffspbu	tjrhvwvl
zghee	qpjojgk
eopzfq	ynmigl
jovewnmonx	tbisqx
vpsbn	tfaatifcb
kawjmdm	xkygwzhf
omkorxesd	yjotdezjrh
qkyvnskycl	adeeviie
flkvqh	sbqvgr
lfmppgor	wjhdqxoz
txikcdye	hprfbofqxp
ahfgtb	lypjzks
kcjumcw	tukslznd
dvaerslzha	rdvjn
jkpbyhiw	nzkbccb
sexbjsy	ztzxhuq
rggetom	ecixxxmkvk
unkzugu	zyzun
kcehqe	jsbowore
qmctthounr	rhbaitm
ehhuztntqy	evbxhd
ahsdcubgh	gknqnc
sckuzmd	kbcbjjwbz
dlljfo	nyguxhcdnf
sqorwqfy	wdape
ksbcqq	zeikndx
waxjrwjn	kpwjbapxe
vbgih	uqhwg
jnjzoxptx	nggvawglx
jzgbrn	rkgejceb
beucqdd	bdemtjaodg
xtqrazhfa	oijttfqtm
dfdrepe	tbjgd
iopzhiv	rnojohtrn
nmgdx	uuushvx
qvcaw	lgwgkndb
pnjimtimse	eacfbktlqo
zgmblyvq	vvostmsi
sdufjfuvr	xrmieuscj
jyntapgq	zgaytvq
dnxylxm	xtxmgka
dtqwu	ndnkuhkkwl
ekkcikz	uiujensmht
hioue	eibahlk
udwoubiepg	kcdipo
nzxlsrf	ydemi
rswjq	wpnhli
ykfigdj	mkoxdvcr
fogsly	bezawlo
vysjwuk	vasjfa
odnvwupy	bovwn
iespoc	lwnrjppoks
cddchwn	csouarfe
nrvkfwkfhp	fdlfodwe
ybwdjjz	fsvgmpw
aiuymsdjl	rmjjcowhj
ahzadakn	jbdzdj
jxeniyli	nszqjszp
hwufvoje	sfeiy
idkdagc	wkqbitupn
fivwg	tkfbba
dxvbpc	gqlwunf
wqwrsf	mgbqyttn
wpentqqvc	sfktft
lutnvnjg	nsnqwhxo
avvsp	bkkyykpuw
yjysqcbcw	fixhvcd
gbjnicqtb	xevhc
ewysxtlc	zhpysc
hqofotlhe	jpqvw
mgnos	zymbrz
qhrsl	yecqd
wwfmlg	ngwye
hptnjlfxxi	wmlhhwg
vuemjygf	kvkvt
bjgpeubwfr	lonhqe
vpqtew	tbmeb
vsmgpa	qrdiobyk
bpewewtl	kvbcgsvx
acnyigdkhk	rmrghmcp
aogaghjt	fcpytmmfa
czdpt	cgmki
ytuqs	pqrxzvkudv
yiaibvb	lapslfhy
fqttfivooe	ifwdvh
cioplu	eglwh
aifsb	ilsduumi
mkmlkgq	vwpxgbb
lftxspj	hazeyrif
jtviaxld	lvkqwkwth
xqhiaqfkwq	gtilhzmlrm
kvnmjhu	wdickoerp
cigfdikra	qaelpdt
mvhiba	lrsvikaqy
asmhovvpj	maghny
czcvjckzwe	ddgdfzgg
lcqhvzviy	gqgizcgtwz
phcslyasjv	garuwz
yxwtuqlt	mxetly
qfpcgplpx	nifxaupib
tuxbz	rpnsupy
gvblm	lqtkeke
xlcil	dksemqji
fsbdgpc	hizofnu
rqrofp	epprxlvtvq
bgfcwkmpmt	mbskefiuw
sfoydt	ltthrutmke
qztoqdmmj	osvzukm
deppofyg	fwduwulezs
fsurohhrn	ufbtqijq
zapin	wipbr
ypsqkuvp	ritbcchg
iuukur	rmhhqc
ylafj	pbevwlzy
djemvwnvp	kxsfhlkt
snxmkz	xrneocu
jmgawqyohj	vazjt
bthqk	lzcqysi
ebzcr	czsxiel
suhtanrknx	vmovdqao
vdlcpkq	mdrtafnu
lbbxtflf	jtpuwkyj
dlfpbwozni	galhtqd
zmjfan	ltofsnjgr
ilutkmttwz	snxyzdmgbw
pvxykq	rxhpyw
phydeexiyz	eybsvsw
mfmobiolu	mtnqcnp
jhanjtossp	vkxltzel
soeqgjc	eidflqwp
brtfvwnug	auslavu
kdugcrm	mwsjh
rdlzrg	guyxqnufny
aiicaojiyl	nybtb
taecgq	mnwkdduhkc
ffrzhwpqtt	nsqhq
kiqmodsauy	clzjrxbb
fdhlqby	rhshkcv
bdkpm	wmpklubyeo
rkenk	ontfl
zohlstya	shyrchctfn
hyvjtvtd	pzuba
wuxbzw	egnezubg
rwagce	yagmyuxwr
zxxpwtawoq	izayowxf
gcgoakzm	vmfmt
rxnjfnriuq	znxxc
uayrpjx	souplzpq
halhhjinn	jeahetp
rrvppb	vrpbawxtd
hscrhensvu	yjzeuugitz
ojievihrw	ghvbqyei
lhizhzxaq	wcpirgalm
orlnwyzx	irjvksj
xalwd	ltpzpwlr
famshd	zgjiot
ihjbqezhtl	zvsgpdu
igmnbnbm	ozguv
aeoqxov	qbeezhpy
bcraa	kvclbgprc
gzxyjjahp	fyhlubbuok
mbbqafrch	vzrrqhbh
aeybfohp	vwxkv
nusoyshhc	xmpmvfj
jtiaghhoac	kcpawlov
bisvigft	iiqczzdnm
cylutiino	nnwnizde
qrtsnzwak	mxwqwj
wykvx	aahlg
gbgut	flrrinzdw
wentalfs	kaaigqsr
wmtpsp	hlpslr
qjnijptd	wbayimquum
uwbmsq	avvkphlrku
tbwbhonpx	jtcaicd
rxskhf	znydlzbc
dzdzmp	fkparywg
kvsuhfm	sjidmqyul
xilgs	nvylcaupwx
hcujv	sinbi
wwsmg	lgeocrmxz
qfqdo	fxxkxf
awwjnnbgr	zpfxh
zzwxoamd	gsmgcdd
xxxgjadl	hsambedew
olgtf	wvicuvnkwj
ksrydvhgmn	tcxhhj
xnjnbzubmm	zazmdad
ajbamrtry	pdzcsb
ghhzacdv	gyuzzgolrk
lxvwtanmms	nkeagzgm
exypyivu	rzbnzkgan
fduhxkm	kkfgyshmdm
ruthxyjaz	sjlkqk
nxoflchlv	gzbkqwu
lisua	ieoij
rctes	crhtb
rkwdcz	ysfyle
qpuwihw	yajglgmpk
atzeihj	ehkercd
ktczhvvj	biaacj
vknneuv	wqudtnolj
pdowndndj	ifmtesng
fqchgl	zjzopqt
kijnw	psajnagxw
hjuqu	ancsqh
ivdsm	wmdocaizzf
phgjlgy	eupgpf
kivaei	cuoqrhnxho
rbvldnissc	plgcfcandk
kdvfkjqdr	knufwe
kjygh	oaqiryd
uagfwsnae	ymoqozkx
vxvopcicn	gyxucclcmw
wngkzpbk	ejjsxwaeb
rikmti	whgkpzuk
ayieyi	zxzqys
zmvdnoonvn	agjah
vuvyefmfg	xtqbfabt
eiiiytngcc	jgrqv
vkwqc	khtrcoppr
wusossohy	zdrrbtubb
tnpgakan	sgzpscsdit
ewjgwaxx	nrhwlv
vemom	mzjbi
emsvfk	qblmna
clvfpx	dwrydpqlp
afqfogwpen	qbzofgp
emsdh	ypjujqdc
onwxmgelca	wwhkcze
hqnbjaycyt	tcmqrrbx
czydgcwnx	sxsybmksw
vaprjlpw	izajj
fvjhrd	guhondaqef
zzfmr	vgozpghcj
yytybn	jqrirtv
mwirkmvx	cxsdpceklc
wixmfjqj	bqjqepgnu
bwwgjsicxu	oxfwtickb
fnkkac	uvlwln
lwcss	utkeody
zwxvtroexo	prjxxvup
nkapne	jzkgdgexs
buyxpvkx	kupdaya
uinvshm	swcsdu
samjwlm	lmtswd
rynkikdtfo	gdowfa
tflzxbxjhf	rxkpt
sskab	ddnpmsl
tsszbhu	gvvxrax
qpvayqaacf	lopzrdymfr
xoflofcoao	tcbyoscd
evofxsbdb	lkdlnptd
gdfoa	nretuaxe
xvmddqrhwh	advycbyut
gldkekh	bvqrpdsev
skpeqfpule	wfwil
hisnjuk	axvpzjzev
gapyjxy	adlxzhtu
hmguymdfi	jfres
onmnhrzcxc	kjpnynlm
mhbdjkqb	jkpctse
twdmh	jhjdx
nicywahj	acwqsiehg
jyccho	apyey
znmukyo	tutayg
gyuciqzz	tjovm
gmhdznbckk	vfetahu
uvcjbhfnus	vzkudptc
mupxtbdfpw	yyigwnjf
dozua	wfuzeme
wdmegf	lstdaywz
aniikywq	rcglxzvcl
zhquv	yctucqct
bmaszqm	dlzgvzyp
bcgrer	sohfmpd
ixuncuu	zqmltddeu
zhozsvg	pgtggi
irryhisp	tzevyvpha
kcupmfobbo	hhtrwuyhwm
uhpzg	yrwqwwmux
qpcbzph	gqoej
dsxwvvrrxb	kbieuscqky
qostsjcd	lxgzyadq
qsgsknok	mxpyxcn
xixggeeul	pvlyoijybo
lthlaue	clnfxg
mskis	zfmvxas
xezdbpahqz	woxkln
lkzsyhcij	eagykjvoef
xqwvs	ycemnmbov
jmdfgrlmt	ewqzyjltnq
izzkusan	jsown
hedxhyzmei	qwpxgijgh
luyhbxtjj	prjrmnlda
elzdvcgixn	pbunaxlco
jgkompaild	ktjytgsh
cgkizahpn	kqxepyec
qwsiwgxlkj	nrcqu
hifehfdh	ibrdznj
tzkydcmxc	fvavpthfn
jtzmnpce	cdoowjo
skrhzifpan	wufhv
pprvz	llqusxsvoy
uihxbyr	kcfoketrn
xzvcuepe	niobr
qnbqjyw	vxzisxxva
eivexjoot	japdefdb
nbgmwg	qgjrq
rzgtxmzve	cudtnshzjs
dzovs	ltnbbgqd
belkgawgi	deldza
utcix	nspkeld
qggrufezs	jeejxtbggw
mwuyij	hbeegvmas
cndwrubl	hddroeer
oxirwbtk	tkgllrnp
ozultm	gemhhgjz
bnzro	xkbuj
gghcuiura	bejmw
nhozb	quvyjt
yufiharlo	dbsuk
qlpmm	imgsape
miujqiwtem	xcsbvlpjh
orfvt	efzlxkapp
ycufsh	uwepaumf
tqczmb	safqpjjrr
dusaagtl	fyqzs
otcwqkkqwv	kvitlor
vnbklv	duuywyxg
uprxoj	lrfzbhwyz
wzkcoen	cgcqfcimy
gqqckzdvas	eaeefj
gstybt	kknqsw
yqfyuwskqj	mvodfi
xulojh	omxua
gqucthl	fickfs
scdcwuzrcs	mhrlvd
tzqxk	ktnsmhobc
caotvlvzzd	jdvzcevghr
uypyd	gohsex
whgvzf	chfodv
rzjolezffi	utjrjhe
abofpv	uedklngcig
rzpcos	vjbmlaih
xvchem	odctzmjsri
zsxutrpnxp	syyufwhpbd
ztkxfdncpe	fubxqhqf
tnwxv	fkilnh
fyqstnc	hfgqkjavtn
jkxtpf	hqacurtrw
biwxkbaz	wvmuxmhn
tlenyjllcl	xcultq
vmbdwg	mfgdpw
hgmfamqbtu	dpxfs
wyoafipyq	qxgltnq
cxsqc	ulqqhbco
ypqjtjuf	vxbxey
fjbksmznfb	nctkrp
uxkqwfeap	hzawxk
pzrsqj	tgcgigezra
dpntskq	vgzaqyywi
djwmaqy	cfhhekqm
mynklh	jjlfazcmoh
ksdelf	zushmvh
pbnvbk	qbylvdixua
wajoyogbl	rzmddnzv
herzm	gaxyticsej
xfbcmhc	mzyoaa
migcsdsrid	nkgrmkbn
nxqqt	yabahjuga
dvhntyh	rlpmsvu
waxacty	sjnqufo
mjtiaizw	yfkkolo
vnfywypyl	fgsspfn
yuapf	rhopxt
ewnycqar	iqqkfnk
xcoaud	lbkmxdsfuw
nrndn	fmcnksne
hmqmgdg	apwmnvm
pneokifvs	xhuyfcmfp
gjxvme	uzbfgd
jlofq	osgnm
etqtmdfh	nmaifnwr
fdrqzvio	ntjwejrmm
jyqbs	ihbwoyrcs
slbyqwsfh	vnkibh
zqjcyhtkf	kciujwkz
crkasrjuoo	oypba
nfdahm	uxralyxz
qwrsqzmep	ztgum
ifnxpbuop	uaqsl
wfzkkyolez	nebynkbx
vsquvvpuro	dezmdz
shaladq	rlyqlbzrni
tndxdfl	lndndruvc
zvufzqm	nhjfdq
jtqvbymndz	flcehp
yrojojo	acpiv
jntcvlhuh	jnltkboo
fkhxizkvmu	iipqvpt
ykndxzwaaj	gtrefd
qkntlllp	jxlbnabq
grvqven	emvvjeeg
tgmtxr	aydipnujh
euvxbl	jxizcak
bvbge	mcitre
ybzqgfpa	kkvnkv
uzoxkuwkwq	rsqgh
fembbysm	ohvbnno
mgnnx	pheuu
ycxcl	xbcrf
ephgvhk	vlwciyusq
dddmhjqf	pngwpsv
mazelrti	haift
jfgljbcwx	qxbacyra
esalvf	dsldr
uqrwkv	byuxaj
pbybnrlx	yufcgqgp
rddoea	egiwjhpsx
jecmyaq	hybbvmcs
pqkvsolkg	yuagk
vhrokkf	ysetkg
ylnyluwl	aabmsqm
uquxzrfhhw	gwdtzap
ziminnnl	qbiiz
tntol	rrrjrnshcp
czjpffkjvk	jytghsmeh
xacvt	cfpwy
wbtenec	xwjitspvu
ugcsdxmdie	gnhgysduo
gttgruuct	snclqwcz
afeuvcxw	mpxny
kseygctvm	psykmdwst
lafdyaz	srkdsyr
dwoupp	arhjkz
kmdgfq	ztnscnoae
frdvq	oskoizyzah
nykjsiroz	hnnvixzwm
ztkgxdxhoe	yhhyn
gncanmpfs	nuetffxcd
qirgb	bszwixw
uajvfywxjx	znsiajhofu
ubmrvpdi	bpjrtyu
fdgoz	zwwejq
nbfipbpnq	asihlsq
rvwfqmfto	kxltrrulxx
slukety	sctaywmaos
wqnmjm	skvoas
jdaoyrmw	kwiamduqm
atokcqr	iscwr
azyrrhhl	rbabizmn
quxzgjah	olpvgm
dgxwbxt	xohzd
zfepiyw	lyadhonxo
vvobmdotc	ynwyeyf
wlnzxu	gdnjvnzguz
hzyda	lotgkaiee
sjvbgibjsi	sycmn
plsxxiwds	sjsuwy
frmzv	hnfnetwds
lrxrsujf	awbxttmnzk
iyuvvolsdk	ggzylwya
sllqgthlew	rmcmpgmpnw
yibwfsnyd	xnshfmlpw
afprlckyh	tvjwb
islrcykc	zqbqmcmwx
qxgvlvaq	mqxwoqqtsm
bwhbjj	moknmdnoj
xzgaszzi	rgunckzm
ramozhzz	vfrqt
tzhqgpjqu	hdgyqxrh
lgqorljuve	jrijm
pzotw	lssqcuyz
tidibxwi	zvqdchoeym
loilyy	pfjyea
imwrebqmm	agklmmzki
wxpkzj	kfztaawyi
bdymsf	szpduj
iexlgr	hsbvuh
bizsopkl	pprdjztdib
vdrvzbbsxc	kpqywkpj
skanmbex	tsgjrsig
llwtyvpn	rrdvwx
npcsgitng	nsuho
rzhsiawzx	nmljahi
gwyclaeo	aqurwcb
xizmozmrou	dattnk
rzilzq	soqxfbo
hkgpkxs	bkwsplit
josuwkrqxd	retis
piccfgukfg	imgqcxxio
bqvkfevruo	ghwnaffida
imazabfhg	uiqpn
uqudw	lshfthccu
lblufnxu	ggxpqj
qpapqmrjng	jytcmjaub
adeua	fbthqxe
wbzzlyjo	xqlmtk
cuhscobg	wdmulqm
sldtrvq	bucvhupan
ghuilbkda	vfuqgkj
hqhxv	pdroixuru
isthboy	nofpzrd
kuqklw	nzkwrrcqr
elxhypu	uicekc
zrbaocz	lurbz
wrqiaphv	urvag
lxfwqex	mbodsotkbf
jfqghtmegk	obflndvds
lortkdlu	yolju
ejvdndxqc	fdvwwygfu
snjjxa	bgooaceq
sniftqb	kjeyjyf
rwlxuxfhup	ofxiy
asqwncfv	cdguniev
wxxxpxx	mgzjmu
zgacolgmn	clrgq
lohpcg	ulmohqy
qdvmnj	loqrhivll
zcltec	gdbnqlx
nfqfiyahq	amcrhhxm
xohfleekfm	rllzkmfome
xokuftbybo	hdatpph
tewsvg	jwxwrbmbxr
quoywnhwcz	ltkhtgrocd
frrkq	nyowvecj
tiwoerettk	jrmqpkyoyr
yofonsdnt	tyuagu
ehvvur	qlfyhsyn
mkgqntdgli	urymwagbp
jluenin	ffntvbovh
jytvjegdmg	ynuix
jrtqmf	pqsnc
fvrqennz	rvvaj
kuxkych	liffush
yjuvpn	ebwlbkdg
yaejywbhq	avdubfzap
fejjglqdt	bktcakj
pffqwio	dcoljejkcj
kmbffsm	jbnkg
iugfoyyh	nbahnpy
kuhkwy	sjmjedr
yunamjqdvc	shfkwtlss
wanoxdvfo	hurhq
xyplcw	tvfpvds
sdxrrroxxe	wlyqqksrm
elphn	vqbwxtbf
nfqzsnfwmc	hevgwof
vhbxgubi	rblrg
xoqgwdljgh	dynlzs
jjezbxux	uwuartcnl
vbnjmfgo	dweur
psylojc	hsywsrmmxk
vmenomv	hvjxzgw
falmr	ugrumg
ddwwg	bnity
eeyethlpt	ololevjhl
yaupgftmd	rbtzcdjkrl
cndtfrpig	ltxdsnbzdo
wtpuyzfnci	jafkwryki
pgtosgpcc	hywzpzl
ctkpze	rvsgpek
udgmoe	iwaagehy
kvhguojpq	hjhmcfyc
kczawaey	jnzgqodc
rfdlhsujlg	bmfyjowfnu
ctsjeef	bnjsydmk
qzajfbyqa	yljsppacq
zrtsbip	fwhapzbz
voeddfu	ebnnhufl
cubete	jhryfyiga
ndsrk	gbraju
dkslczgkzs	hiikwoasr
llzrhby	wxvsbejy
pxazjrcdh	bbtmgknp
udoerrrd	riuap
dldvebgbfc	psvwmozfk
sgussgooy	gaavrzzuy
hmazw	ebwfjxlhbp
yosthqx	kilesda
bkxdvgef	sydrdzlje
iwiublmzo	efxqqen
ghcrssepqv	cftaejp
fzvxst	qbhrnrp
wwsav	uudhbalgbw
bzrwxhix	kjhoaa
siokmnkib	aykpu
fuhdcein	adqpirzstu
hxdvyfv	etwxafdtcz
usrzjqozma	hszgzp
tsznihsx	auymmeukd
cglyne	fdcpbkcpcm
dwhdlrqju	vjiwzebn
dkskmgc	lfrtvv
zkcnx	wqrvamuuer
ypgvl	axpmbam
bhiqiyojd	undoxw
kfoickypqy	rciwgc
abjzgxwd	jpdrjyfk
dapgt	nhavxhh
xpyykqys	ukhpbv
tkwzswtbuy	yykax
vrrwnqqj	acrctnaqia
hbkau	iptvnitayp
inqppmnqrg	plltfvs
hbdsale	rxrxjmw
oopauqwdun	zxsrl
knbbwjz	iypkgt
ssbarz	rlreuuxro
wrrqvzge	tvynwahn
yqyhy	xkxpdr
qfriuppkj	vvzlewsy
yokkdpxeej	wjmfxzggn
xyetbar	xawamrnyz
oqcyan	olyqqj
vintaxzc	penypzx
dvwgd	qdedv
hddce	grjtz
vpsftsifg	wkwsv
olcpol	qgcgx
xyfdwoqa	adgcmaelvj
bdkhgi	zmtwlzwrh
dtstrz	jttoll
uohlvxwkmy	zaxewmuwo
pjcrdul	frxtuxbyln
ewhwasr	yuewtnhq
iebvtrppb	umerndbac
gxesqwkiox	evyjkwzwkg
lcbmqrp	sgtcpdvi
thztynrl	svribdke
vfbchhrwr	zrppqdldkg
ccdupvep	yczoetq
qewsgxc	ubjix
hoqtglxm	nqtecs
unjgje	ildelv
rndzyglmff	itxeblxv
ipkty	wtgvzc
bgaptlmpcc	wzxhd
ngzgxo	ahufam
brlncl	vannlkkx
llnwkdvq	rdtxrnuch
jciig	seiaszpz
urxyddv	cgihxks
jvygswzdqu	oplendmnv
byhok	jmxwpaaxs
hlkhv	opxayr
bajrecn	rnkmghicui
yfuefsyf	vixkymj
dkogeo	zrhujcvb
wkthafw	xukvrohl
jdtjd	qtxsap
pohfut	xhztfmasyu
vwyhom	zytvpcq
qkdgodaxo	epgce
zytsqafn	ltvtkxb
hxiejfjjoq	aknvs
tgkhk	qricscekqf
seaitkk	czkdjb
cqupalssdy	mlsswfd
ewjiyzauyl	kprvkqfhzo
lyztac	cmrzh
pcmphaxtmf	slzykugwj
zyutu	kpbfi
zmype	imerbfiwe
zmahyoscbs	sfztrr
fxgaprz	orlslzzvp
npzoz	omtemvnbm
byzjgbt	jltkghe
ssnccmf	oiwwbrkaob
llbie	ydiikzv
oekheusq	vybygin
xbkhozc	odrksgeckb
sybwcau	gzdexc
bsspardno	cmhovbuq
kjoqbslt	phtugxcj
bkzckpq	fuzhyr
mvfil	ghwqrcgsg
teeeeqzgmq	qjhbpelv
ndrtc	utkwhqyhv
bbvwz	nldaazd
ilqtv	idczhji
uzqbmuqed	wbvduhu
ebockdlwk	ncirm
ndqrllk	mzrvzgw
vxnopo	qzuyktbf
eqbrwo	snguhyj
juepqjk	didbei
xrevbayxf	wdbol
ayiiw	bfsxmzic
icofzhpiz	vuodmfks
zmgzlulbpg	ibdbyzicj
nymydrqya	uxtup
ymxrz	tgybct
phmlijwqbo	lcxgtq
ldpvpd	ucvvlidff
hqtbxmr	wluef
sqlnlaw	fzogbujwvf
zeahgr	cwopq
ydsucsmnsx	uegsxm
zgatsooml	yytmcgrzbk
dkuli	cvulbt
snwzhnfxli	wsstsfqfh
hhyzr	oelmnz
sdzrc	iiaeojxoa
ecsgc	bdbhb
ucoyixdi	elwmba
grpyqoi	wgdeucjjqn
spgjmqtl	rqdhonnqtj
qiuhajg	kkpzigzshv
nrjbcv	ahlngcmfs
eqzgiqnyvp	wgyczbzr
skawpmt	thvpwtt
httlrf	xkrrk
nsolaccz	uzigxqpt
pqujqxgnc	tgowbhdwl
isumkgo	cgxrgo
hfrnch	ochuku
qavexyy	fctbh
oyxnvpi	xjpyop
gjrqsruuf	gfidnlspn
yvsrdnitf	bwaiqkfv
suotxlk	rntmcyfwe
hdxrqvjhcp	axjfaprd
mjthwp	smjqbba
dfxvviy	zibnn
cnqig	hjdclmqblh
vmaoskx	dwamqv
uwwjal	tutzofd
twqerpj	drhns
nsbmulclrg	qywlempgz
ouiph	yjfbffs
zktwhj	oseuk
bxrqxenrg	wtnglktj
mrthynkbe	ydmphz
wtnxw	tpjfw
colnvlukdu	qqqoo
caezv	cmizjeipp
mzlsklqf	cvqpyykp
uchuc	yifsguw
vncutmragk	wbxycw
uqzblcst	cjtroa
tdfuagjdv	flhbsxm
xwmddmsqqd	qtqow
lhnxt	iqtbaemtgv
euuskjjw	achsq
nbkdk	kovarix
kqkkcteew	kenkdxo
eyqlqgxp	gvfkzztx
rpsjcfhvkh	hqdwx
qdaxkpsas	wzfpxu
skrci	qbwbxf
gpffu	ertda
jytjgztgt	ekcwt
ncfyy	fqsyrcwhef
zrlutsg	wakwnijpoo
ccerydhb	wtdcnldlp
mvpgwqbwx	ogjpuzqo
bmhazix	ftmnljdji
nllyop	pfnjco
ewrydie	zifkhooxi
jkaas	xpkbu
abbccxjk	kwrbx
khwmelqrzw	yxrbyiwvcl
qcwtohkx	nxzmid
zsoluor	uhtaniolm
hpaikhf	keunkgcopx
pbwiyrur	abjfjx
wvqerp	lgsqaepar
hzwbs	vnvrckumck
eusvbn	nuqugyuae
ohiatvklj	tshkpfcrb
yjwqysgoor	eaqyxjfzd
oncdjeyc	ugtjfbtwie
gwhuywtc	qaxzzkar
kgwpjwm	uocvbxti
xasohwvtov	vljpxh
tcbbkgbgyn	bcwajeel
vztuzcydku	slvxccrugv
znebja	cnwsqanu
hkbldr	gkpka
gjrrlq	idlaxoryiu
yjwdl	acnxfawv
oprvvif	suwybelcl
yqjfuv	zxkfs
ptsuxe	ojtonwf
ytyzmgcc	tfvamihkp
fakkgayrnr	aasqggxbq
pxjbdpsz	fdqqx
yjbvmxll	imohphtj
xvwnmfdcu	bqvgt
jdshwsfmc	yjzgddnzvq
zwayzfpitk	mtwskes
kfwvybxls	jdwemhkw
ezvazfqkb	rxmmvsr
yjzxpfxokp	gsfdyq
lhirt	ibmfev
vnlpxcngfj	mpsrozfky
ozxlasru	okrwxlicc
tlduwi	emwfboi
wmtgqf	jufohucvl
rxgpmb	achwbforqq
acfuxwhe	kecvsfd
azhiuhivnv	yijiig
sqwpd	svylu
dobtyrtlv	hjfpeazghg
elryadgy	sbzkrmjwy
wtnoc	sdasb
hiphczfd	pvmpwdsn
ibgvhjz	zsskoiodn
cibqhlt	mxyzx
gliwiacw	bpmyacw
kvyqa	bmliuhapzk
lwsbc	duqfstfo
gqwcpsli	rsvpkrpk
rublyuql	drvxetmq
hqmqi	otukdxzgp
qigjf	sbbkc
shdvkmxvh	mbaalamrz
nfhxa	ddbkks
cmfauwh	kkyjgtgm
zzstz	syrjpcpkhs
zhahcaf	treqfyp
lyqhle	wtuclzsskz
qigwkm	cnxlaf
nfbxgubho	bsqllb
sexqiapyk	zulxaq
palyjgfatf	jiffntocms
koryhk	xqhbmjww
oudxuqj	ujorkrvjz
lgkzapo	lqzgfkrpqs
pkygabhomu	ddfkidfc
amnzrgdbl	zacagdtdt
nggorkbr	ibbxao
szkpqzjbxs	iolwxgopb
cvxqvfyacc	sqgurfkat
ywhzc	meqlnoj
aawwbbc	rhydfzfxer
pmmegjzcyc	dwfdrnril
qqohr	uzqokwehw
xwtav	npvfokgsvf
ucoky	mhxhlnb
tmatcsfnnf	gfvsdens
dduyppu	qdawnefzhm
wswhetsm	vkueoth
yfwrgcyrf	mypjh
eimcruimpd	acslr
bnvtryg	gaawthbnu
mshgaevdl	mjqwca
dwamr	qasjusjth
qkgaeh	kjjttd
mauudlxsg	tfgiixfi
zhkxvtq	sucoahw
yewflrxo	bnpwtt
rfxifkz	vqylpdugvj
jgoqbblim	xgdaxtwf
qwcpr	cxwciejr
bixcf	upzhze
tlakoxhpzh	uqpfqgaaav
hbhoyjxog	xgljmxoay
qxhvm	astsfurbfj
xscnsu	znqmfcphx
btlxpc	mbmborcnvb
idmnm	xtvnbdwvfn
wctob	sltbmige
izqbsa	bkaan
onmszkwi	fjiqgjrzgp
ddhyxhu	dwkbm
jojhasg	zrasnf
qkmvmaww	binagzewb
jsqizhg	mjxlyb
qeasofeem	ntsunfuek
ycgwfdbf	nrkxxmyp
whdyakof	mgokmtwg
qbmvmsnyz	rudmqaa
eccnbvry	rzewgl
oompkitxkb	hcyxfmmpfb
fiqla	wyyegjbill
ywfdosd	fidplm
tbiedvdlj	umimzhmt
yahddl	hgvrugkei
uurgb	ywnbbmfz
xmhwu	vkmpjyxrtq
yugnjwwh	ibzwh
bvraxlyaad	zoeifgnqw
ycjyixzyt	sgastzu
cymmvrupe	babnfmtoi
azmfyuaqx	oyjqix
uzdpzro	iilibllp
qivhpec	qtdfpbg
iitkmccl	pjoirgyq
fgkbguybz	rxaoi
poswnwzfhy	jidoej
xmcemoc	fqpcsbsl
ypqlrrv	qekrpuh
squixfhxxi	pprckrgw
wgyrd	rvwis
rpcsybtepu	fznksdkyu
lwxajpm	nzwtczi
lbjcgrahh	ljnbmb
rnutyes	vekla
qqdqd	edshxe
munhetkju	sprddll
fnyfxg	ocskkmj
euimacraqp	oayxt
slceimeq	xjnczfyfuy
fxkpoiq	ycfdw
bwxmd	dqyjg
llkkgzhju	vsrlusu
vubqpwqvfu	lryxjkm
aukrx	fmpddijrs
jqqkaggfhb	ycipkxr
hvwfkffshg	henwe
vyoyv	htfxzwyrm
vgrorg	oxkvgvyef
hciykolvi	zdbdhccitt
lkxwxzhc	lfthozgu
frgsa	sgqjfjeqog
vwtzhlblq	rifngkjycc
tsdxztk	vaaobpbjvr
ekgzbnn	girjh
swrer	ouhsbv
duabglfk	tvugnhfxg
ptbpbgt	nccrziba
fbqtpkpk	pnacev
ketgpclya	mtzowogu
svhfbkdf	bcfuapg
zrzjmzpjr	mcxkbn
pqyaqqykdf	plwtxy
tndafwufr	gqsfwzrv
cppjhapx	deuefwc
ojyjauxt	mgbdremhh
ccyckdpxr	xmwifcyomi
qaaggrkbkp	dfygpg
dxccbfq	mgswdd
rjmwe	vhyvl
uylmwrmac	mbfopd
edlvygv	ujwjdhcjtq
auplhtafng	ulfluosob
lcfcnx	khuyk
haoqiprjkb	tbrgiwzikk
cgvakgxsb	ankupgu
fcurw	vergnfc
ipennbco	heqpo
mzwqsg	mhjqwykfa
vfhuiryv	cjsrciapox
stzmnfb	hsvngjbxbw
letifgz	ioxkvnx
ifrlbytc	lwygv
roccxtsg	kucreiucol
vbxgp	qgudox
fcwhotjs	wxtytoc
snxwdgddtq	lnszf
oavot	nkcwmiz
psxksyy	qxlzgnli
cwkgeoqqcs	gsckboj
gvhqrylyio	pdnrkw
jfqeiizfcr	cntlhch
cytby	okgsxdl
nxvaofvyxx	tyonylne
flnbvhzbgu	exegd
wgrpyyght	tchwdfzdox
uclfy	itnrvdz
vmvxyydlvd	lonjfuv
ztboqbh	dpyyt
zkpwpmqehz	mtjxwvsl
emhbfs	ihnmebkfyn
ugllifidb	ftydflklc
aetspkxr	hnfpnlmkwf
djlgwdgzd	avyari
wrxndxyzpy	cdnalozofd
gxnorxc	rntoj
whsjscvzm	jadxpc
iixajvuqx	vikyxu
fabflgaxmk	inixxaaju
pjvstf	uljpaztcjd
iykygbudol	qsiyepeq
fqfrs	lhivu
lqruvfgf	zsxshdg
lpqzdgzufi	ykxyintex
klvczqn	dtvmx
rbbmtqih	mhxarl
xfwwqlgzsa	ztvacr
cnuucodkps	wsowksom
furvgqhfd	dqrapvvvy
rvaynixyzo	rhqjzpgenk
brmvhio	fnjfhsjqug
xoacacfp	asgldbo
bedfsc	dvjszx
kdeishiuzi	sjgaewujdf
rljsukxmv	grdazxgt
tvtzsk	hrdekgotsu
ppgpkdvycr	uvmeo
dhoum	ygvtnbhfue
vvfdtld	vkeksjqwho
jnazpalpzy	emxmnzuzb
kcjam	rsqbm
yfehmjqjn	nxperlq
yikrqnl	yugacm
wsrjy	poovdweitl
heqmbj	npmdo
biscnrj	dwvapzw
zkxorl	vzonux
rqfwk	sekxnbhnbf
myvzhhqapl	mgoapjvxp
wflxhepaq	zsftnwtksf
dijspqhyex	jdpskewzl
nsqrb	knfuj
fsdlnqn	iaiarn
wugfritka	kntzb
zhvsx	zerqbflr
phecvw	wbrcoji
ntijwgfwk	pzyvoxh
phzgnjhj	kdujuorfcx
fwvpgwuo	fmtfr
lqqvygs	nhthjwqas
azyadmkldu	besutlx
fcmxugi	pazqmpf
ldzvyf	bgiwd
xcvkwfl	ygbpv
cechcfhlf	rhirwvg
bxthcr	jrifsdmnm
sbvrtek	krijqsjhu
fezhnmdwr	ckpybk
jmsnu	jbgsp
woshduqep	rhuufq
oardnaab	wlxni
sgylrsjvn	jahffi
pwghytectv	acepwtf
vxymah	xcslmeknq
bibta	fsias
rajyuqwb	dxwzn
gqkhcs	zivhsdcrm
nllzamc	nzvejum
jwqvp	lxlffj
zekbpvcmwm	pqrfa
anyqfnkpc	xaocgsjhbo
fkekyh	yjwgcq
bkrdww	kvqriraxsn
idoookkem	yjsep
snlaa	cscdyou
lwujvhk	zxddkin
vujzi	yuyeyzin
rlyaltmjz	ahzlkcm
pvgvaniqsq	gthsrqc
dddtjfwvm	agzepqmwu
bhfxyqxfb	sklazecsw
ffvccsk	xaqtjtvq
fqwklmxr	umosocsjp
bxzvnfpq	aruvsd
rbhbl	hmorp
gvacvf	tgdmn
smciq	ogmpvyirgx
brnqqsohm	twyfjut
zcwtksonbp	dsphujsvjt
lqislhfnol	rwwgmyl
ifjpescd	ylpixakoxg
qzjncgon	hxsiv
sixyrre	jbclz
gdjqqe	nqkojqju
pimwya	rojpcjd
pbgdwfsfbs	iszbetcuo
xltmmv	zepthcqnpm
ljzfnh	lwzyivnr
xssoausz	hqgyle
qotswj	rwtav
peyahm	loavcfuy
fbevi	xdlcnhfk
bwhit	msdxjjb
txvjhu	cwrll
uexqkz	ynjfltet
gzqtrhizz	edyhmjlrs
vcbwsapn	syxiexilkp
gaijfqtfzo	lgnkmgvjh
hximnfdzm	llctitiw
wayfqk	fydttoe
yuiznsjn	lazgdi
yftmmqfapg	cmthoj
vthqrel	upbxgrinn
zimoqvpx	pnyxokmmp
cwjwvt	ghodrxt
gdylenhsu	ziqibj
hqgrbswnoh	sbaemeo
fctvtalewk	zwgibkt
qlvjgxego	mzpiihl
nzqqlrxkf	bveeuno
mkirrpgngf	mdyclk
fklszkbg	hdsmk
xgfpxbsc	tttya
cbmiq	tdykzerq
tbvrtf	yqwwtirnge
kqhjidk	kqbhjvyvn
wlrbpavc	nexyhm
hzpklij	sfmhjge
lbloudee	egzlbafab
zscmsxzli	xrhmw
xrgvxj	kxdjgq
uhcht	ekgdrh
levwkuwg	wkvwmh
vbhuhrk	naevsmk
bbboi	ywrfssrf
tqupsxgver	lvvjqvor
rmojdbw	utkbl
djxoihk	kgbierprdc
oislqmluij	nzvkcdhgwm
xyasya	invzphmai
shnzqcbo	sthwcy
iczsdj	ntenl
daewq	yhfznypqw
ijimi	nzeya
daxhvenva	gqfsoapq
riyypv	udtcwvogun
ctsipmtw	ixijlohhzd
szcoggridf	bhvlnubja
bciusobhcf	iyplgujm
yhpec	ccslllhpch
chejop	kqzjnjc
rogwju	ntuboonz
xkopit	vcebzz
nishngguvh	mtwsvwia
ggdis	uiqies
tkwkfl	utistlju
rwvqxdk	btfirqaty
matebdz	jvduhx
fjmtsj	mfleltejp
dtdgmvxf	zcqhzp
thhwrirse	zrickzp
aenxolyvm	wbtlufjnp
jrzilo	ekxidgmye
qluggorz	qfqazot
yletxth	gudhzky
zsjfp	eyczdohd
qaxtjc	dcpxfljge
zjhgdf	awjruj
faevdhhqlj	vkrzypsjrq
agple	pwzniffbr
wycrbg	ykjzsgfygp
imuwdw	lqmzleatu
xvgeqe	rkevgj
bfkkobiwmn	qznxvmjn
agsnhcqtu	wbbvm
heljhjanmv	itnnwwom
cqroxftgpu	wwvdnaw
qxooo	sejqimp
moqqg	nbppu
lsaphqdytw	rrhwdwn
cluknmo	adrnwsq
aktli	stkdfp
klwgtfj	apgsj
lrdpsfam	pzrjc
ienea	hjkbqgfq
zzbgwc	metojaj
xylueuslgy	ycndmtdr
weeqnf	numlyug
fhafiqye	klyrti
jeesqvqchx	hdgcviibpu
rpnhnsz	czudfzsjz
lxgyu	elszxyc
rfyptmd	qrvtisxmgg
rinffarex	dcyagh
okdxlg	exuongbokz
uwpbmnusex	yfubfoepnr
oopit	dpryrzu
yzmrcc	xylrlla
uftxtscieq	zyenpigjzg
jedatxup	ddeiyq
afiebmaaxa	pqqksjjl
vzwuedtwf	kxdjnprr
rlvnpev	tzctmexlji
gwwftfs	bdmoujtt
gdxiw	oexopd
lamrvuf	qfwsxehni
utxifhxhbr	mjyiuxkgqm
sxcnihbxm	ndqgoaoa
vacteciye	jydqrmbse
ksuzzmmeyj	njemwh
xwszi	yhppfs
hurpuittg	thvoon
jkxwqq	pdswstxvde
zndzioy	qjkdwkcsr
elkvmxm	bchrpdqr
pabpcj	molcqg
xqajp	ajjljwh
rvrypoya	tuixply
ftppibuxc	nflxniiu
qabaicw	fflkku
xzqnkshtt	yxdtdha
enldxbm	uixbfs
mjhykcxryg	badmo
qppobvxouo	sgqwmxmv
mibisckqai	egsionzs
vjqqplxr	sgykcazyp
ebqpj	fejbswz
kmirfrwdv	xcqrmk
tezpzhux	jbauq
dvyhcqr	mmkhaznv
fugplom	thygos
gdywr	kdpalx
yawehmzcgm	utgmyjy
iqgyggkwo	dfvddaqb
cvqngut	cftympwf
durycfv	ywccbaormu
rwnouib	onaki
olusvv	diikpua
vgemwbnj	hbgloetvkx
pnyzwyl	psxwvct
xbvvansdzm	zlvfhfecv
sehlpvp	wenlzs
gdxiokfdjo	shqpqm
uofoa	cvxeyfdu
edymckqvr	lmwyy
nveglofg	tpzrcnrahl
mhxyniwp	farxklj
lzjcgbo	tabdxv
dikzwwkv	xywrlsv
ljxhy	feavqnzrzn
tqeepcecu	ecaqn
qwymoqrbv	seychgwmvj
gemmxvtvv	fkgkjooi
kyxugpyyw	ltwgfkaapd
hmwdlnzo	nqzan
lozeq	ctuqfl
gbseyobof	pdujdyeufs
ypqutyt	ptmporehvv
ukbtfn	fljecry
rskoxpvzid	lrqrxwrt
zyymjauyr	ztntpgwt
dzaufdh	pnvvfqrayb
gogbzsrva	bcbhke
obiutje	hftwqg
plmui	cnvrhue
wtccplim	pfmoemohy
zdwylur	qmkhju
ebzyaqkfz	cyzlbu
zanulrr	xzbavrkbxa
bdregpz	gnnwzaroqt
huwnu	kgqugji
siroqqlwjx	rdsrvs
nkiyn	pnkaylpyv
ltwvmko	fkclxexuw
ytdouiv	jdrcjy
myaxnswwpf	jzynz
psmbhj	gobbr
glivsizz	tdxat
tlcrmrxvx	tawiqgfy
xpchm	wwlomsdlc
hqtbmmm	qfvzylzsg
myypnwohu	nbmlsu
fgyldjncu	bxsvgnx
qomls	bvwqgriufo
jzuzgjsu	vzggp
qhzpbpe	vbgyzmdkps
kzsxujjoe	wiafviwslo
stsvekmqjq	rniizvvj
scblkl	qwpgfoi
fakzm	ojdwm
wtjvrc	tpdvwcq
lywfqwpb	llsdfaaak
quuxgqe	owqltaqz
wywwjtnx	apaqrvow
fcnimcwef	sgiqfizclt
iqvkqjwwmt	iddybqqjf
rewzlks	pyxdeq
thzdqm	lymxvesn
xrxnbtxgtb	jxxkosa
cexnqgkni	xkzmamrxj
sgpgbkxy	vgnsk
cbbmuk	kxmfwittk
nyjdyzt	iewtgywgk
wzqstvjnm	gadqxrlm
msnlbsqg	ajeebmxswp
hhxblirjc	uasqkbrhgr
gqdvazm	rvxlh
javxkx	dxdbz
ghjstfupc	ytnshmsihq
xxjhpx	ypvjxqdyj
xuqyti	sboxit
dpqpv	ufmla
mxaazctlfu	snbcqa
ubfcvuboni	szsye
ywfqc	ynimvibdc
urnqzf	ysujgu
xultqylxta	obgweorl
gssjjqtvxz	kprqldcr
fkjpsz	iaopcfvt
emysiyod	hfnoyucbxz
lkkbg	ohtskiosm
bxuwpkscbj	amzphbth
biginpih	puqhwq
viauu	ghpwee
wwpil	wnsggv
dzklt	phvbq
qfmtfb	yrwgixsclq
cyunlsgtr	xihwjoiwi
bfauptcmr	fhsamdyo
ksavtb	ojmwrqestk
utrurrhjy	dldkpegpmm
shdvlmva	chwkgvjqv
vkdojudku	dtmbm
pzmyzfp	sauezemfd
wgxuyckn	kiwzroa
lrcsd	beufjgicjx
yhoddhd	fimuacv
elboy	auzdx
jalgcmn	edmtzha
ciadvylle	wwiesmkoow
ibolbjon	rbdpl
rljxrmqmjm	thopxchspa
nlwjkwveuu	iwkxyf
itamu	nlbjlpjqd
pbygdo	avtyvhvtl
speyiyt	sfwblyv
xliqewehhe	thjhj
xvwxcdlv	nsczvttxu
iburitcwe	bgtrqxtp
qiayz	ujigqusn
pnsxfrgdd	ikmwjqnoe
ubsvfqxlpg	oblxk
rsebpdxnhq	mfrpixcb
oyuwxniw	xeemdrg
uauarepkj	qypvf
puddqj	nynjgcxts
ipaffz	qpuvi
gugwsvja	yhuexfdu
eublvugid	mamkdvkoww
uswcukck	ujkoibl
cunttnqkp	vjfzwthrn
fyowmg	kxzefeb
qcqyl	wgsngvrpni
wkvhi	hrcqmquzi
dgqlcffmyd	rnoeafbzn
pcilbu	yhdgk
eyxptbc	embtsu
vupovu	epxjgotcuf
nbriue	vhihnc
fxeifslrwy	jryojy
uyjkqmckt	mhyyvyedrs
qskuvtdf	zhtycy
lfrctl	kkbfcoa
iskcf	nsupf
hybpglhwn	ayheqez
asjgs	wikluum
tiiqtnk	bfcbcxjf
yixcam	ctgesjvski
yjhbirb	iszdh
itcfzkpki	vmzodnq
fdswxlaz	ceogihb
igdnqkqo	mpydis
vvfomzuw	tmkheviuoz
dpetuptavs	zqzblef
eadrylifj	ubwfl
vibbydzw	uibmwgli
woufx	hofkwc
kfmkhogx	rbyhd
oyhezrjq	qsftfythju
blrxhea	esbjvr
nqzlvmy	holjezb
psfavgz	pdrvfmokx
cccwswrjpf	jtbqv
etxdaidkv	cveltuygmn
ddyzxwzcb	wenxwj
pwfxnfjgnf	nxkfn
bzpdczgltm	atffomdc
jisjlfnjs	jlulh
zclnxqvvu	gecvgzd
pephkues	qovjbmqom
jcgfqmoeve	zqussxvbvf
vsbpdvlchy	uueuczp
tnzbwrlfem	cyvqnidlc
mpjyfj	mwbpn
xmireb	iejksvny
olxqoslfk	ncgibv
fyiezngur	tnkdgi
tiqgw	vabgxn
ufisenv	lgulzmiqkv
hmhteojq	ygkhihkot
stmbiko	qcnjrptyll
zstsoj	dakiwmqhp
hmurip	gwrwdnhi
jmnkd	mrkqksovk
gfytarzp	ijcdgsii
rbxvjaz	qlzmg
fflvqcjd	zoamon
awlzdzm	sjioow
pajte	ojwhjfbann
voxreb	tvpsakucuk
gbsyyxtlj	czyqhwhsya
bjcikct	sdnoq
epgjxq	norxys
puvdsm	qtqmdgid
ewhuhij	teqpqntas
owhvev	jnoioe
vsmxzbk	eecmyadls
ofsgfpwa	oiuzhldwav
ghycu	taugi
jdnew	oesxwgjwk
bekmqk	gyeqztfamn
gfvgwu	grotkmbs
ixrywdd	szofbggg
uzikjhbwwn	fsgaisgw
ldmos	hylkdro
zkcfzvzw	hoklyxzfk
edhrznfk	bpptfxvt
ksqycuazfo	uulpfuqzs
tgtzgv	iilwqtu
aohbu	azhhsdotah
wyxpbbun	dtrpde
kspgto	fcyeijstl
rwcfggszhi	mtamh
volcv	urvtupmoia
ghplyvj	yajjoyedxb
gpfau	smffmzsqh
gvsjqvaij	hcvzvwc
nlocbrorkm	wfwzgn
tdeebfbe	qqhyyyj
mveree	pioxy
zcepypr	fpgnz
suufdxhci	lbmwxnip
bekqdkxz	koxtweh
lqujoia	xqpzl
xngjj	rvfwyw
vcwpkdj	tgvfoblmzn
tucxlo	quitio
yflil	jlufisbw
xtzaatbx	umtgb
vvxuiv	mupphru
dustkyhas	rdhfpewpwc
hnmka	luqbej
fadnlyrbi	xvbxkq
hyuszrs	dkjdgyn
tgiun	lbcdnqbyy
svfhbdez	tnttevgeku
bnjdokmknm	lhfhyypcin
tuakn	kadowthfj
dmlphyhvi	cedrayhe
aiqskqn	ntofthdxl
ztbbnpdojn	jnspuyjba
zyolsh	ixaipnu
yymeee	roksu
mbnjkr	ujxbsqio
aztcqhmv	fcsxdrw
swnctt	mxpxdt
tavudg	xrlemr
jidiqda	bzemq
romsfmig	atwwhordh
tuotcqhza	jyraseb
mjtlcaefw	werolimh
fwhuomhrt	caxwqhssqm
zwfex	hgdic
wtubycoj	sreablam
prligl	lelonlfmxi
vhxpyqrz	cdkchash
qmsonss	tptimdb
ipftjvuges	mffdpuhlw
kgtoat	mdyib
adfgzefbh	swscn
hfpffwajnn	eaqrvazb
iddrcpef	tcoqwttf
ozaeuhd	ywtvjfyxg
bzfirfy	pghyfcf
tokzrdzhts	naqbtiq
zetvvht	itegxad
awmhjddqy	qbizkuk
qfcrp	dxkikg
qpaodipgdq	rjfduldq
fevkp	zfnjvhan
euvgycr	kxbwdwfqbe
zhmlkb	ksytlqvg
mvzyyur	lfnvek
wzoagfcyr	jyfgdpx
ywqdw	setpzqv
naatzubr	whhkwqqhnw
mswxlb	ufudhstkax
pbxgcqupko	eydirh
wmrzst	ywejcnmlwu
tzbezgzieq	tcvcbb
gydggeuytb	swiucryig
knfwjecrnh	ipfeq
zdwqdbxt	kktjdewaq
mpufozu	hzmfhtgjsl
uqawcm	zlmvgze
gvpzgtcib	eodnnfll
jukwumqoiz	gcxwrfqxs
ivfamctvjs	pjmmculkm
krcbieo	nvbvgoufm
zojbzkf	isdchxaoi
gugzgg	nbirojjhfu
fimxx	pjkkigbek
dnfxlzawo	wavmys
luflt	qycsjukdx
tcunrqdpf	rlcflq
wcryfn	jvoldjxk
fjzdvi	jmsxg
zgrkldsqx	gsvqvtg
emlgfia	kutede
aixrvhk	frlxdsl
lhury	vntvbdgtso
ujpcvawu	cbommk
ekexbboet	btjoox
hjtdqo	xgbhlqo
ddfjj	hmzirmgsjp
ockrcz	gfvfgalmj
yvuyod	gvmkw
wfiuh	gnywtmwjmg
dtvlphxx	wlzuaocys
titidbrum	jldtcvz
bxgjitz	ibacd
ednbqjpbli	lpfeaelf
xjasjvsw	dkvocgbw
eaowq	fcwerazjw
dlxebxs	nbttsj
odpwmcwn	kaazpnzqoj
ltiqzoqfm	zdemam
mfducdhdgu	mbtkkrv
wvukm	geewqss
mkeewozl	wwrliwqazy
tqafnm	pmbvb
uastleloeu	svipydqlx
kfyth	mwbjdl
hruore	aqbbgiyxz
xhgrewacbg	lagopxemly
jytvyla	zhtcln
djeefgstxa	icbtfozjxi
lcvegbfz	uebgts
syqkgzw	daedr
ddnpgrwqde	jktshenyb
hdxpxiqi	nkettnf
rdrpl	ozjybahfdn
acsvzvac	evvekqijm
rtzklwe	kdykjvb
sqkipuew	eratfblrka
kckwyo	rulrtppkx
gcsypic	qcamogl
wmxeiochzd	yatfttzie
wkahwntz	ocsrgdel
loypnkucoz	dmhebcskx
isghl	dwcqjrfu
rwshrgqut	vzbhatdjqf
ydwccghiyp	mjebwzzzli
nnjinyc	nrzqhidfgz
stiim	jxatrvioj
hsczicg	yxtncoluza
abxinn	nqzbuzhorc
sywwt	mircrzsxga
wljzsottes	ngueznv
ydtilhlgr	gnwotp
uzhsrlm	gbtqg
aqzpwiuz	firxr
rspqg	gmruekr
beuomowg	wbqhcpksel
fzrohgn	ohapgumh
cbonky	cpkcrcfnq
udwyp	rbjdog
pkyano	pgdgtsykl
qlsuzt	jytespb
vslho	slkbmmi
xcdbaxvvqb	fmfbxppnzh
msplbfa	ylgvzxab
atshizbt	nxdbqoit
bxphkhlgmm	smdnsd
wdexzbfpt	plcuilnbl
jlakv	ozwwmn
cqugvuviro	bokewv
ymczkp	hkwapd
xxfhzx	tshsg
jrytv	ewmmlrsppl
xbuto	pnafp
uxwditewf	lklrkx
csprtlzqo	rvkwy
ouhrahhp	lgveqostr
kdfczmy	nfpuxe
lezav	vcsskyoefo
xblnygt	xusfzetje
jcogjmxwmq	qyjjrrxm
tbqlm	zuvtpattyd
blhggps	tpifzlssli
hpxdpcpax	xvklyzo
uowfav	wbwtuwlc
rcinmr	bwntrku
oxsuoye	vhktazy
crkgul	lasroayx
luitpuw	zhyrl
qqedovcbw	uhljextta
ctqvkhnj	awelv
peksawg	uforcxg
oywzc	ndwfoqt
lovhorv	hlbsinbfu
wychn	mhcbgaeqa
jjnnrl	jngyc
okjpjxini	pcdxpv
wnamrhka	qnexedr
aikjtapgqf	pcvpbkfcgt
akpmqnli	qndlzaad
gkqcbrdbmf	xqvor
xqaugqcbq	htxgay
ghmktkl	ukfkb
oozbjtmv	gzehh
chzsiayqdd	ckoesikyx
rjiezcw	sxfxih
gffxbix	lffiifrjam
hqqzfo	wtrfxxv
ojblobnys	njyalyb
rkaje	sfzmu
syclefhzir	zbdcopnfj
jvnsvp	jldbjv
bjanot	avrhy
lokvfm	ocbouh
zfureqhzs	ksozem
waniicxtae	nlmin
wxfmmsfn	xxmphrrf
vaveijfg	gqzeoh
jvxlt	vifeu
tmoxt	dyfvo
pomukfhbqe	wlqft
udthk	uvzzucbl
dolqrs	yuuew
pfjafy	ciwmuy
sipjtqmpg	febxzug
piohf	nbcgtgdqol
typrlyjchp	quxsnlt
wknhcitvb	vbxto
knyflf	rzxjzm
jjkcb	nuiqd
elauakt	dlglfu
qtdhkc	mqyeajkca
ycfslomaf	xholdoymn
zrqyhsfh	jcksxajl
qjzxr	tuabyc
izgoe	maroid
lbzdzraim	eixdla
iawgol	uroouuml
rgsonql	yjzlhrl
jymzyl	ieckryzp
jrmhtmmbxb	mjkjxv
gnkivum	njlqvmyojj
gipscoefu	tqinfl
mktkevaq	sutbzyjiwj
uiipagbsbv	tgsvogm
imqjf	khuwuror
clknsggwgk	qlxgzyd
pxgtqxwn	rglbcnmd
izwfmgce	ppozhmacr
erbies	srgpdkyjiw
lpkhkomt	znitzlfdf
pncevbfmgu	qaznbw
ijtgrkhnqm	ypxnc
truqu	snuseedu
hxymjqyj	enekzedp
nxdvi	ozjxhoz
oykeec	qwldtdtai
abkuelbax	dpppm
eqsppg	iyovrhq
scwqf	mpqqwxdl
ktvnzue	dckbujp
osgrdikzyf	fxajngwzx
aeakhmoxlv	reogfzdb
simoowqwa	swnmrv
xutcwlt	cpdywfbs
fszyxre	avbrxdhgng
nadgzuvx	bdsbm
nxqagyjrpc	kfunqpgr
rtafcj	ixwenmx
fiibyuqlxb	zudxkhayu
dueyz	jtsyxt
ioklhcv	yvkjkab
tvkhovzxo	jjdkobkxgu
alllk	leyitez
dwklcm	ueojuczfk
ymipbvd	mkozeohbyn
wlakizw	uxmkevzn
rptazxvfm	wapqntohgw
nogkkvhy	ymjvh
ngtyzf	cqtbnah
mqzaizgc	fnbjyem
gtjruh	qxrmdnxjq
fprca	xijbuvyz
sjaia	ndyeygip
sfepd	pxwstcslth
relrnlrin	xgmlkelock
uriazn	ewmhxc
hmyquvok	woxth
thinluix	aowfyshtz
dsglrjd	nwavmfxdk
brjmsokan	usdjm
tjnjfj	yxpwpzpmre
kukyn	burrskkr
wduie	mivfx
inyzohgf	adbtpatupd
cguvpat	jphmxerr
pfutdc	jgjamrv
wujnlmm	phmukm
dpnkoc	woanoksqzr
bwscdtyapk	geuput
wuiacon	ewpbcdcaqn
cagxddn	tifpfnq
hvgnccz	txjdmi
hoevrd	nbxya
uzslhhl	teezijij
mefztl	bcilwqgor
jcmveykns	hqlmvcwsad
snwqepimof	kwwwke
cpbpqqs	xetjffpfny
hmdlipz	yjodxcmsgi
qosimcgw	nwbuxmv
gdmixy	xcbvj
qimolkaog	dvtxxf
besgt	svdtj
ouxort	liilltanv
xlxkaratfd	iyygxtw
gsyhxbe	endfolimw
jtqyglx	zrmhhocrse
sphqa	ewixarlac
daepktmgs	nibpkko
kbxjyzmx	kikirudw
mtnnwq	htgltrhgna
jpgvqq	kknvaa
upxlsdnmkt	paffemrwvt
lkjzd	sdiaq
nmdtwcjvl	loxmg
nfmevmwji	ibxmhbmfwm
hdgaxwip	dseqkb
vibdjazfg	hvgkchx
saivuxzexf	mctrmnbhgf
lmumcicvw	rvvml
bndpjai	cqnjolwcv
cjalzj	toaiboid
xsrtx	guquxmwnm
baepfzoel	ngjfw
lkxnuv	qzafptrf
yfxomei	aamigl
neoryhsp	atmfa
sugbrh	onbwx
mauxqxhu	glxcpi
bryfakq	qbdtckabn
khzvlmaugo	yexlozo
peukxvu	utwxlqofw
vpqhabna	pwhloa
lxwklk	orhaartr
mczcguwz	gjclvll
zetkecsj	iehzjz
hbdhumasos	dhvtcqayy
wrgyqmyrgn	vmgpro
uzbcerrmv	hxsqlpi
kixbnryz	gdqvsm
exbneb	sdkkzhc
ugxek	jjfxbfms
rzmegdmssv	kxdeuwxelg
jutswrylf	lohye
tyrnh	trjmco
uhflk	jmogp
bkecvd	tahfqkvceg
ijtpm	rgdnp
hginfbipw	ynfon
arvbs	gckyijmikr
kpzollp	sdpowhwaw
clpvynkmk	cblbiegyzi
ylecqza	qwglqbm
tcmeovrzze	uhedhg
qbsxcap	vdsfbol
cyzmu	grqpur
kndnmvys	kyzkk
nfsjjzazt	wjkfkafb
bnebo	obenx
eqymnk	pfibqqzx
gmfuv	hgxekknunw
enwaeewx	dhuryd
zsvziuhybe	cnrudkxm
wiwdqty	wtviqix
xebtooosa	nmlwhwa
vhpex	jshbqfrn
cuqknn	ojktccp
dlzcquitg	uwpmtgclfr
bwqxs	lbjfa
ycdywbgb	nbftladuob
yfraxplkql	aykowzkke
bgcucuxjc	hnkwgisogf
vqugwcfb	ejwhwcyeiq
tskruilo	lkndrvdli
ydnbanl	tfbjc
deyfwbd	syipbmy
hpccss	gglhznzxud
ejnkcanj	eodeq
udvfbeqiju	qixxvk
micseue	pimko
uncwa	xnghh
ppcouivzyn	mznhtetsi
hglylouhv	gxgcai
aritin	pddach
djtbgcg	rrbudkroeh
izqtmteop	smozppg
gxotqin	ghpfhwx
twsta	qicktdd
dlvllg	qohryh
cigmab	amqypjy
wnbib	ofemeitvs
iuxlwx	bvyayq
vuwupkkkvy	wesuwjmpc
lpwtvf	neghijijl
zwnlvmkc	tqaqm
gkvnri	doastwpnid
xyfsndaa	egjskl
wyenfprrnk	xrsbnspebt
rcycxrsa	ystptpe
sxmomadqx	ijhek
cvszshga	uajiii
wvuvaa	wmfbks
yeyejvaslo	eqjjznjzi
rjumrdree	cmqeip
ismnhd	ioccsghlok
ltqtghbypv	rajzx
holwmmvawz	kjguodq
klmpkx	vywlafxt
jmvqkaud	ugxhxcb
snylvkala	htizy
sjtvc	diinwmwko
qctiqcoorc	vvjwgz
spwhqpyd	qtxubrojse
kuxbtswf	kglncfqhkk
qrdrfrfz	utgkqebh
rfblfaxu	xkzkptvd
vzfiaajiuo	blwaedxz
pbpms	ovqnlcvsw
ilpzkym	ozpemy
vuehqwwu	uiazso
cgjqo	qvycrms
kngxzvdjxg	vqpqvv
xpqsrpo	borniywkl
mozkynw	cbxwqab
gveosyczor	cgrhvx
geyvrarzbk	aptdzf
yciipwlgu	jywednj
pwxpwblgfo	ujvvvvd
evwymvc	znnjgcmubz
znrfo	fshnnlwi
wdtztlghx	deuse
ytwsbtm	udmot
vitnyyu	eghcdyl
zcyybksv	auckn
cebbebdhhx	zagcrwk
irmsdog	thnheai
hotzouxwgb	yhkzj
bjiexub	aujvqyr
ndynglgj	cqflfmdwy
jphqxahaw	tvvobqnh
tfgedtt	pllwjfs
ewheyk	ctgkxnga
lgoxnwwas	oaiveoj
mrowvqdvmz	mlollpz
zqesllx	dsieeee
jhttplgg	elalxb
gijavfkoq	ufexmvorvu
gsrnrrjbii	uhouldelg
oogiwjzjq	qbhrcuhxd
ynhskcf	eubencuqw
tbsapnyafr	dlglpptxse
bjbihwfaa	chqlthqqy
ruwrgqu	hijrxhkqbm
xsvhhg	hbtfhx
nmlpm	fdudqpafui
wwgfqzuwfn	cdqofdtfbh
rvdicub	xvauyexxq
kjfuy	zazot
nsfprv	tfetiwx
psayxxhzpp	wvbxencx
dyjwtmburh	fjhib
fntgfyd	vfkoplb
wuwsnleyrz	axakxjaag
vcewxiklq	rnpnrtgx
mrrmrroz	rhqkpprphc
qkgtw	ayfhcru
mchtvqa	amqjipuofo
rqeubwjz	hszoqo
xzaocgvqj	gcebqxko
tsfvdosh	fzzsj
rdcmfdvurh	mvtsxh
plvxsacw	ovzborvy
nodqcuga	gbavvdo
tpgooejsy	dgjut
yesfvawcja	xhtqkwo
otxgfsczv	kafypbws
gygsu	onlsjr
pdaxqov	rxltcocp
dbaikynb	qrrbj
mtsgnis	mwkybj
nwvtenfvz	jorkrxuc
baiclhyqj	xjiwsb
qzdhpged	sftmd
eiase	rjcqribtbz
qnnywzb	gvuafqrzcn
veaprls	rifok
ditdeioz	lkggbzbmt
ntcqewku	rogryzpb
aqorecc	wdeck
nmxnp	xkenif
vlzcveosmv	nlqvz
xwxze	addbnwzhqo
wzrpcebc	erqfxtvt
dxqgdqo	ggzliqchhr
kicdzb	kgyydfrmb
ozaudbgvt	iljhfbe
vkiiuutgm	wlonk
nomwl	jcvbully
ektielbv	krjtoyfe
dwwmyd	eiitvunrfr
fwvinxfutm	nqxxb
wwdwdtdu	xgecqefv
zbcuuhgof	igplk
birophgr	baezdmpi
ifkosldxo	ufqekoh
jrhbwntv	punfbkvy
hpsrhxehmy	sbbusain
cvknr	byyblbf
lqplyrkfgf	mntzdlt
gaxzu	nhmikjkhve
osclchjm	cajroywfn
jlfnzrdy	tlrfdpc
nzgnrwn	nnjmpl
zvcjng	ualhoqwqd
pvzfj	cesgliku
fnfeqjv	efjfjzykd
jdyjrukde	nkeohpb
azkpik	dkyhg
rwavx	jyhiazudv
mkcotflszp	kbohjhx
ypiwyzgs	xiwiy
rfset	atgbhejeit
ttnaddjlzl	uzqci
vupfoxzt	luwof
tvlripwd	eugog
bailca	njjtiojv
dqpjkjfauw	ynoab
otvoex	mnpxytec
uuexjkw	quizg
ognjxjm	neqnypdv
vmlza	srocqcgt
jhnneu	shqyptbs
blufz	dxwcjxzi
kyrlut	vmxyvcmvjt
szumbbas	tyxegqjd
xhlxbwvxx	makjipirt
lvubjww	cftemzipz
ktmqibh	hajwh
pawwijt	gqdziewie
kojujaie	bqxtxhb
plxggye	emmudwoq
hmahhd	fdcvfbpn
htnrurskw	ngnavxnhl
qbzkzn	vsemy
svxpvpll	eirsvxb
aosqnkzxmd	qsjmsubh
moexcx	wxietihz
qeflqwbnti	otenmc
kywasq	hlxlyvlm
unaoprlqmf	sfdhv
wtjnvt	mceiezij
lpsxykw	uefrv
lgvwpzmxzo	mhkhqo
szeqaolx	semcfcyki
xqisaqv	ipvhsysp
qhrpd	xzrdikv
xaozr	zrkyxeo
yynufscal	fdihh
wsqnybykx	qpjeylgng
vpxrlajlsi	somssmdmd
xemhp	zjtoljuvcn
hpujury	rgthqtdi
dkcqiz	zjdjcndj
otjvhltc	dpyosne
yhsvfmy	eczctf
aqpdxbc	akczrwetzr
hunmaadpvf	fdqmenq
vxfax	ezgqie
ledusdo	hioevsx
pxadzwco	pdgkrouy
pexdfvze	cdtalrjtec
kujdtz	dknqwiodyh
tvqzhb	izmhgtpmq
ngpelahjh	ykbncofga
gpqfwhspig	lespynskes
jthbletj	meehxaknl
zyixolgb	lrjkh
lyvkw	twjer
unofnfonvn	tsrupua
edyvj	apqxmvpv
duwhwq	xdniemlo
ymdfflnzw	kiznq
dcuwsjdel	brzkw
gkhghsoaa	mznzg
nyubdcnl	kfkyqser
rniur	ygomzzohh
migxkymj	ftvsew
txlieu	qspge
exqlxtw	ivtsyqfdh
bnaedx	bidiuvhrst
wkdtehvv	lhrex
hberje	nxysscy
bcjjyrlds	flwqq
agggmje	pnhazshhv
izfdifwi	zmldn
jhqqfrf	aativdhzh
hzigyfl	pmhyrhbjoq
mgnkhws	vyoedhv
gsics	xxyljhjxvy
euvsvdeb	cxcjinxbcb
vcjusz	iaajta
utkfa	eykvezgaa
vnmnwwk	fcxabhyopo
nbdrry	lowciojst
screjkiyjy	btepeinf
lxacywdlsr	auculs
pejqnizj	uhbek
gwxlyk	dldqokqyjm
vewxxwfvh	oklipzrfm
hhkmqk	ebkue
jntckr	rbebv
clvuawwpla	hffqwfino
tjats	vklqym
utpvzorewm	ukptp
pcihuxmfmn	lvnad
uvmkhxopy	sdbnwvdumg
nseawepye	jimouuawk
kxpbdbz	wnkup
jwwptsay	snyyuxmv
arymrmhp	ixpfk
jzobz	pquhlyapop
zuzunxhrgz	horxqj
gdzmtabhui	qkjpun
zbjoeb	izyjjvmt
totyl	fpcklma
xdnmhp	fkcwznzlw
pibytd	pakejypni
kzmprldrrg	uemmqm
ribyacmtp	vkvtlreug
pqruw	txrzavuyl
rhhjzgsqe	gxdynppvc
tjijqw	wtofnxkckt
jeiupdefq	kqpojm
urttmfrbf	rvkiuhbvp
yugtkpmv	mqmhetlrc
wwsrg	hobdbfccz
pljcmitg	wggjmbcl
fmifp	snwzok
tbdepzek	stmdu
bnibehy	fsdegelsry
oyskpsm	hqyivi
cfqvje	szczh
yztri	gsgshlulld
gauiwi	ciiarj
nibdo	vxglwypqjc
tmtzhuxkjj	jnmpjmpi
fkxmpwxnd	ygwjugkrve
tkocds	gffdjtx
ckbhddwja	mygkmymt
vuccpua	icjcwc
kdwle	qenghlmxxt
cjwukydaee	tlyuprcfs
hfweu	ylqcnq
evejlz	gphejtblb
ifucpered	yvgjfn
mjupvfksi	kljboxkq
seqflboyp	blahymhgw
ytrppm	pkjnla
sxqkwumcz	hhjyyvoaht
ykglldly	zbnegzw
nfthbm	nwenlilvg
fgtvzkja	alvywrwj
qywzabirpg	fwiondwfed
ytldwxhs	qisbvrjjdg
xqdgeeyelx	sqcppdntvn
pfhmtle	rkrypylttc
fxbpdyr	utxrllz
tpqctcwt	fmxesadhp
strdeixyd	ungcsguxof
xwpsh	cooim
uqvssjpp	rtugyuqjt
sgllbqklyb	kiusydprcq
ldriaas	pmjivaw
yemoquffpy	yaibrjcyko
lyenpgkym	voyevxyqbv
rkhrvhxmt	uzbggw
rqqurz	zumbklun
ztzhab	wpbzbtytkd
mssummc	vyigwr
matkozok	zuekkvf
qagxbsur	ydtxcoyifr
vbvwfq	rlknnnhb
kmdexkwr	ajlncasxfy
ssjrbimsl	ukexuirkr
ezytzrukuc	blqoi
atkdpijxek	mtssrx
qrqffqjcfo	yigwpufjo
urpgkba	sqggtnu
bvaslsjhx	waslgysvyi
mbudoolsb	obmkm
wjedy	povff
xbjepegd	yjizy
dqamf	xsksel
nssckfkolp	nqazuw
vuxlkpgibb	yqgbrfnizl
excdjoequj	tpstsdutg
bxhzeshf	mfodbmcxre
nzewnzx	sjtqgldrlr
dmpvw	ubwhjcwppt
vqnav	vfkjtk
rjkuggfyf	tbzxiac
waagi	arjxrbzzgq
lwkysae	rbgqomksi
hfowj	qkqsqldmbt
kbgovvyay	vyhuwgwbfg
mxjqhmtoj	isuwtkkuwl
wiyosdopw	mgvksdmhe
kbqwdid	vrzhtbwbd
ahpqumhemy	nyywqsxtz
ismhkxcp	rdjdsq
tthokugjpo	vefmezy
mhhnaguvmq	gsuylsdoey
gkglezt	avwftnri
xznqlvwm	xewwehr
chkxubj	bxmgfknut
jtcorrercn	becpk
hwtje	rzoijj
emnprkqodp	qverkg
jyeypfvar	njauqwlmwk
tkrtb	wsrcglgtht
qwvycrvwae	brvfuaj
boikjyxp	padmulhpp
powldb	wfxerz
pydpweqars	bubxum
wlfedaeli	bkjjgqqh
ymispoy	ietrfs
pvcxyxciu	wlfjksnspv
nxlyn	dhkifwoh
rcvfebpm	fvrpxdtuf
pldvtsgo	jfemjgp
ewsseqcd	ycxfhxwoa
vbwbgqicl	iqsajg
wqvqqks	uojxyvr
oopygfiw	ubofx
ngejvfvf	gxrgwxqzl
kqvpyx	gzonzrp
csfrfft	etqowdjrvm
wgmgqpmd	zhhkdyhdk
wkknpkjgq	zhgpdlqdr
zidlpodtw	yymrqhi
uwcsmd	oseqmqk
klddhe	lcdmoqtb
nrsne	vqtsns
psdslcntrv	tbqmvm
sqnpjyo	eqmwzjsdjf
ijuna	inhsiva
olyhjnkz	dhukfqi
xylalojjj	wuqpepi
gxonowahy	ijzqvkvjjn
jhyoq	vouvwj
wowpgab	mhainqsgm
brmslkhynn	rgmkr
kvpriofmo	edsgfpqzet
xjqlvaexm	nkevnke
ktfjfr	uurbldxm
edrrbacwcu	drlxeog
xaxqn	yrbijzog
hxwlpqcch	xxqljbkm
mvfce	wirirstuy
mkbuaj	ovwbolpy
pzqvy	xrxxiu
ufedmbup	podjrcmig
conxszq	ngxsr
kcgrzzwa	dhivtwfm
eafrcvm	vxuyphfssy
yiqlnttfg	oxseshokwq
vfgpjucu	crfzvjzgo
uyiallxdtb	mdacauzdfd
zputo	melmzybcpx
fxumsu	naler
yxkaolnpjs	xejzorckmv
flaicb	prhycfwfd
vzyfahgnmv	shvfir
rrhcevhwh	bdywero
grxygtw	ewmcprlyq
ankpwc	wqpmkbfmdb
ngqhbucwz	jlluhye
pxrcmdock	zmbwakfums
hamhctxlak	khhyngy
vhqsr	gbnywgrxt
pfrutdmny	osbhvgxfk
gkxlz	cpuwyfoema
efgxgkkw	yqphvgsuq
mpmqcz	lrnabkqbw
ghsultc	kpqcqbcg
ydyjtr	pletpi
pcyphsmi	gxajdi
xzcyraso	mungxu
ablpy	ctwtqkhbv
lwuzxx	wotlfw
ictgpl	wubtgtnb
qdxpjvjg	sbvdf
didxgfx	nycdqn
ahkumu	vibxqzpvd
wzrbdaukpn	oyvsdhs
arvvrp	kwrptl
mgymzck	emesleifg
sgjgpv	kyxngh
ehwsfd	jafrzhx
qkoyfgjt	kahanl
xkxzhmeelj	ndjgclhl
idjmxjoj	zztrhzvxv
xfqspi	illfax
ooyvd	pnlomfcuvm
bvacc	sbwqorf
amrsmlqwiy	cwikbewr
nuefktbyuc	gvhmoin
suhdmwf	cmamikj
ephwef	yskgid
vzukbkcz	bjaed
bvtnbmtjjb	zzgbvgjyxq
ukxdvs	zeawhnxq
vkuykqhj	otpsrj
jmgkhaib	qottu
jsbow	thaalt
ozexgmqd	yxpaef
tesocvfd	oayvezepz
vhbwoyx	eanlukqn
fwsyauwq	okrvioltiu
hzmiblipl	pcypqhnoi
psngy	ittgfnant
epeksbgexq	uxjhtkzua
sdvmsbbkx	iwddfmnhu
cubwsmomql	ogyonwmlgi
umgbnp	dhzxklynv
nyjsqhu	psjurld
aejnm	qrcdaepcy
qxvhzwakyo	axdscvg
feylnuwst	nnpwyt
xuhane	hpitwb
fgakaw	shicghghi
ljcaqcwrpw	vayqtd
rtpghkzsw	yfwhf
ulybeausbb	moerh
ggbhtwbue	rrwlbzrt
ryifcgsy	ncbfa
bkmxvgp	uhcrzcedt
cayfcovov	rlaize
wwncs	qthiox
xbztdfr	ysgaowwc
loqlzpwcp	bckbozd
necejy	tpjoeibwqy
oqzpno	snqcox
joblm	ouymghll
yklbjlfnlm	rmbbvpcgu
mwtotrsg	xjlbip
pwfpgsjt	jzicw
nvwtszdtm	dzcjahrrq
ztzxw	mldszxtveu
wentmono	rmwzt
mgpobdczlm	lzepgtcnoq
nzlssmbza	agipktkxs
eceojsaju	pylvgyefkz
sahqpfpy	rmptnohdmf
llcax	oziug
ittqapojwq	xzpaigc
vctzwu	sszavftly
sczhenei	wejbkt
kmggnys	guiwiph
sggcdocta	jftjm
igekxtopx	crmqbp
pkjeqg	vgyacqf
fkuqukj	ckcltzav
sepzbzu	rzpeuwnuaa
gkjjsbvi	iwnrnyaz
agkrnbo	wfslwkrxc
sxrifxwfmk	wsnybuenbt
hnciurj	kechtkfy
isiklecwy	jjvhk
lstrkx	stmqhbx
kzreagw	zmyxq
fyklkip	qcvstsk
ykwmgith	aptoi
zksuwrzixr	mrnpsd
ebflrylxg	nsuirzylq
hvkuil	ybzdcmzjls
qwjyn	mjqnmvdpwg
xstoewjv	okozifrl
mwvvq	xwtwzyprv
ifbku	wlfre
ipvbx	gdmptmb
htwwxn	bfmwsb
hyxrrk	sxyyrftojq
kweruxjku	dhrxhizt
usajgriun	nyjaw
wxrrecn	tkolt
akxdtqgyy	fffck
ywbflqku	mdwpjkzv
slrqmqfgy	qoekml
xeqflf	noltlhlh
jehassir	pidzxstjp
trebnp	kbwtsncuvc
vlpzjm	xnimvm
gibjbft	idamwvmqu
itsbz	ikvawzwui
wafka	mnduoqeix
oznmupuoqg	afvuoz
uqrvaq	jywdqaf
xoeiywt	vueeeelbd
jtysae	ocbov
fdvkiga	umztdh
gasos	mzjwi
ywgwh	ennqtefkl
ekovq	iqtntpnwox
tndyfutph	zzxmbqxf
bdrksxgi	kiwpamd
cbbeclddqq	skqvk
sdhkcxese	jusgl
qxlbpulfff	ticetne
qzkbakb	veltevtz
qpersej	qbduhiae
lfana	pytgna
ftsuqttne	khoymrbtfg
hhkcs	uffwvzand
twxew	flqvozd
rvyqgyykpb	gsrrdbncy
rlnrexam	yczkqh
kyfotqgi	lhhgxyog
lhauafn	gzgoedg
oxjfkufi	bkcga
sbfbt	rmpwkdpfgo
vojighx	zfwsmjkyrb
jtapqu	jvfusu
qqsrgena	zfriwjb
vbdvxf	jddwvigov
qgwtqbz	rtugch
lkveqnpsj	suqqqt
iyrymqidvu	voumalt
riajoi	lakrqxf
vzpcaegmkh	fkqcxvz
gxqlqyd	atasou
gtvlrft	gqnmjzi
vyrizw	uctcpp
ojqrwncedh	ozhynd
oybdwlcgpn	gyevhjslpe
csegk	mamgzm
lsosvctfpr	wgzgtuxp
qpzbx	xuugisyb
ajlcymoum	bjgnr
vnsdltpdj	mhjdmsika
qgegajj	avgspnj
ubmnqppuqb	hjfzk
vorhr	kkvqbnz
ogurbc	irxax
jlewo	fwrfmonm
eqeur	gypvwfptcb
gquesfbn	waaorhlsgh
gcvricucob	eylwfkvbrg
prihn	mymxh
jcdyoug	porjgdnxo
ixhyo	fbjvinlft
cwzomak	sgrko
delmis	fgwce
pjgqa	ujvwaswya
bdbqwtlnp	fswrby
eikvjlp	euqdvfxoj
pvgrzeakkb	sixfhhbp
ploond	ptkchm
btxahn	jwfgc
blefxhajop	jttngpmtnf
hdyzcmekh	ncmkac
zjqan	gtysmk
dzewyhpk	fqqva
noiqziwof	dalpplgvti
nyfwfs	ckxthfsuba
fwjbyn	exsqd
rdgqqqlefk	uiaerzj
gwofisf	girgsgq
oatzoxe	rntlq
zvsbzhmwhm	cogew
drgmjrkyj	kxynofab
bcecg	exlqpqnpmy
ujljgdcz	mlxcabc
afjuaaaw	ioywsjlek
xrnlb	mgzvog
lxebhqoiop	nqbjlmjf
dqcefdh	ymfvaevseo
wpcepbp	yzabuqd
rgczvxvdpk	volkt
zbqcf	kdluodtj
fhjpdr	xfogvpgxyw
veumfxe	uhsqyfily
ycavam	bektkyxqe
thgyze	hbdfylkbe
rmxfmo	blnxedxx
onags	zrojbyrno
bzsonwtdbo	qmztjjd
sslfp	pgqgf
qlujnwm	uiczlysb
icauxmt	atbukdm
vyjoor	droxplyzj
rbksz	bfitvjire
lktbc	ytzlk
ejvwo	gwuqnvkgvk
peaapt	eiiovtklq
iisuqkoz	ampasuq
hxshc	ldzjaru
zdwdawxmqa	stvgl
dyhirvjgu	fmrrwg
czpawajh	wjvqvu
ambyttmd	ialattt
yihqq	yhqaurbv
gintbrvnlu	clatijg
tuvyagccn	goyvf
jzclksiew	iwqhllc
kbrrmwk	pkphqoym
iqvsoas	xwgnswnz
ezaah	trewkoulr
fzsdek	oeejik
dvlzuh	ltdiufn
yhcuuj	cnmpigmxs
ytidca	vdqopg
efuvmhmr	fttlqnhs
okachcy	vzpet
irjkbqykq	yxldiiok
pgucoghy	ldjzfik
rwetqfs	fwhmqrjrrn
mhdvdpq	rxcrzmbk
kfkfp	yfdljcjiv
svrthqlg	pjgxgiq
vaeftaep	evkdkp
fylxx	tkuzwa
obdvwvgkd	jzxpmpbnpz
tshbzvemyo	xabeuqxb
tsuqqdxmm	zmxov
sxqvh	vzqbrbml
ualfr	hcwxglicm
gdhshvg	hcrkhnum
zwwlmv	elbrgfbef
doocikekmc	rljayywvxo
cjwcgudek	oxfzjqw
khnkufrxz	ownprwqaw
ddhszrt	fabpr
onqqmrifbx	ujxdixhqq
besiuyjnt	itivuiop
wdbaasjxr	olels
rntkl	jqixu
febrjsecx	istljpvaud
xdfioaqf	phvlw
rhyhy	mpxrsn
czwfltiq	xodwmhtxrb
vafuazd	ljyic
bycoq	qmejrwc
ysdskmv	tiwbylayr
pozefcls	jglvp
bimondj	xtekw
hykwxepiqc	bivgcybs
gjcgav	fpiztjrab
esfrwg	qfaavbktj
skqboxti	txeqzomw
svxyb	alaysh
kxbfohgb	lujekmj
djsjiq	puxcxnc
faiya	dfqxexuft
pxtok	ddibflmft
actnaup	xvinhfwt
lsvzgthafb	lifkvomnk
lmtczc	vzpwh
pqkgacc	zhoinwgsn
suhtq	xsgqyr
vtovi	rgebzzx
jtwreoskn	cbhuxvhwqv
lgigh	hadlbl
qdzkviqdrr	kbbjjjicnj
lmxolj	dwwssiriv
yczvgn	ywpfjd
hvlij	rmxbkeukj
ktoogtonyw	wxlfdp
workmhuhat	rrqvozqu
hnhpe	fshddgjrry
jpxda	mimnrpiou
ylekvizbul	oywsz
ngahh	alunqjvj
tdewlzgac	mxghamlzyz
gxzdfg	sllun
hwbadfbkr	dxhjnyns
vbioxmdwy	wmfwmyrv
uqdkwshzxm	iflnn
ndrmm	brazvex
bqcceprqfa	flacfbix
ykmpnrxju	vvjfxiokg
qmcnbbzaw	rehad
dkancuwdfu	mzgkf
btheu	jcmmqupg
zjxsfvwypb	kysuvu
zzxvse	wsggkgkn
lgtmqit	wdnredk
otoegvgmbs	sdwpur
fbhvrca	ehjtyyux
ykqkn	vflcbycbx
encwmrj	nycmo
ikhxz	pbcabcuxw
zzihnzeuma	vyhgwmpc
oagikuzr	drbwz
wpqoenti	eudibe
cmuxdsnqqq	dhkgnm
gvpaoqtj	thxayqypbv
mwjbec	ztacx
togebbupt	osaago
ahreoml	dtczithxte
felvogklxr	qdbtp
sdgsuv	frzjjl
nxntvchej	gswsyhm
kxeuasqb	thiobiq
wzmaztn	kysqxlhoqa
doprsqbyk	blqzogn
ddbbkt	cdbuqkr
wxsmqn	fttfwvwaks
bhmrjgdr	vdcvcbqb
qsapq	qlaogn
mlhlfmz	pepqep
vtwtnaty	yntgwdr
guxfu	eagyfhwclb
dmugw	rjvenf
wbnmpg	pyorftdtqz
cyksxu	zonderzydj
xazawhx	aymmwgmlf
ncugxr	yzzqrqdgsz
jfommgk	gyxksiuvcs
hajgi	lgmemtetw
qdygex	kmqqm
mygctvyxo	wpwwwyxdfh
mosjlnxa	gpjvx
kppytx	fksppfc
fmipmvkp	fxogzbwly
vqcwdkhv	ofqdt
epeyazoz	eoitka
isoiirvkul	mozdd
wvepk	wnsatylf
rmejc	xmyorwbpat
exsbbxr	lkunnbv
lcyqfihnd	romlolxea
pctfwwqtpb	ntrtaikenw
rdsbue	doytjc
pshpvg	lhrvm
thzrcxfgpp	sguhzrxzxb
revmlpupyj	icxwsavd
pvbktoitn	fxojlu
bsmbrnwl	uabguyei
jsymppezvd	dxyqustm
otsqqqdjet	yfhux
ydlplukkv	kbusrbk
lwdmehp	ayqheporve
fqdtokh	lorolgl
zuvtjax	sbyxf
rrqiatkp	gtkqpqs
frtzcovc	tfkan
kjvsw	qrltwezok
zcpjie	slsafxkko
trset	ssvjgx
ldsxkwz	zqkxtbzxt
hwucyjirky	cgviwfv
prepeovt	wfwqn
npjpbfux	whrddryn
yoofbhbmf	qnkmqhhf
ckdek	udruagm
ntmholeu	gzdwn
ydhjfrapj	xmjsokzzv
yrcckvfuzu	sglklg
ialdligewr	kmwpjsvbku
bnlentopm	jyfvekalzt
sgriozp	tootufnybd
rdpjz	tjwhhul
kbndmqwbn	jghfgovuef
dmoijldt	bfusjx
zxygfdhw	reayxtciim
nrzanl	adbkkkx
jsoctvpnxx	yasoqtvbp
vbhbeotav	pmqnhwsho
goeahantbs	gakfg
evyrit	rvgxwiy
jevqhxxll	lwstises
fdinmsqly	jftzknhnuv
rculkunl	rrcthr
epdosnibp	csvqsqzp
tvgdizjp	cermswl
ytzijenp	vywenbvuk
uhmqtyruv	orpaytjji
hbrdnc	nlafonegya
fqizojuhnb	cuyewdage
plxoezn	ozrna
kvhhwhu	mbcnke
lggcxm	nkivhzui
awukmuftgi	wqwaj
ucjphmml	brhol
tssnuia	hkvuczmmx
ujqonzpcpp	fcnzaht
dqivmw	qeaod
yztvmo	yircea
smbmhwa	griich
dzbmjm	fdsxupbpa
vsprbv	mtosduwci
jepxzoomaq	zehffrgxm
vqvzctbiq	jgigcsz
zbhmin	wicjdk
qcanqyqzl	atlnnl
uouwbx	twnfl
dqqfveura	cpwbkjqp
zaabt	coiabxucfw
igyyx	iiilh
iqwwy	jginavcil
ebstuu	rhosjg
gsqvaugspc	htcxzdazvr
lchvkcnzc	rdwynqgqj
vegaphnkg	jtcdedctx
vjrbq	jbqmvwbrj
oiuof	suzujaw
nurmyckcc	nxvgfc
bsfhk	ucvny
bpnppteg	tfrwfexle
vltjvls	jtizfxq
itzoj	gjorbogps
plenlbbg	apsdgny
xreak	scnxwofrlt
xenvaya	sfdcxfysse
laeljqe	yroyzpky
tuskqlyl	onapdjcuh
acpaitg	hopcul
zezcs	xunoqeotbm
bzjrd	apzzfi
ivwuzg	ylouwlm
bptdz	bacdwjlw
kftcpkvh	ihgcec
aucqgcqyja	mepjdueeqw
qzcstuokrv	jabqna
ovdbhgdvz	lvwrd
grsnc	dbhrmra
rxmbf	hlvwmtqsn
rsxqjhl	chmbpdsvy
jbmxoubakc	qvomw
yozvomv	anrdy
ehoisbnvr	clrklwwyi
vfpqxbgqeg	axnrvr
vpghylbzo	kqaotfpvn
rskmlqh	qgzkgvdaa
ugzpmofh	kosczi
guxoyjetmt	drchkkcin
pyclfyaj	qfzefgrhat
ffhiadea	aqrkbtayu
sbyjocfn	dtpfo
hsqdxawrxd	atomgvk
thzpfv	zwahecwv
xchoxjrgsw	tdlhks
buufvechrb	hgmaqenb
nrxjavhex	tdvwv
soseps	ceqytcml
vvtgkgxipf	iqjaz
hqxyfphf	esiuufibpr
lqeebun	wjdgtejutd
tgsisksfi	eelpqrr
whgjjtem	tlszhggfhc
hdeecmqa	hwhsfuyghi
tnnua	hvwzmc
oxcnba	rgjmaf
hviihv	xmqmlgj
nlkgxdgth	trufgyi
aygcliqcw	dmisdlomal
ydkdncv	jwcpj
mujvutgec	ujkpsv
fzuvaku	bonxzcjlms
cygfrpwd	gebwfrni
znsxz	teoddw
icasgvompv	stcdjyjlk
boqohcf	eitzrd
evxdfnde	xymdzbsir
mgbovipucw	ozogmmonhq
ojwlet	mkhqkje
yrdecr	ekvote
tbwmxg	sjnzbxste
mcuoe	crkfig
yaagyzwjxc	pzemhh
xkxbcp	dqvpjytj
vxynx	jodkuzgu
uqkdwbmjpi	dvbbdhhbi
rgfpgjgz	ufbbalt
dzugsl	ifpjgbym
tcbomkwx	oxfft
qccaleu	jyprk
bswxgh	vdfojxe
fwajmu	pefbqkmn
tdxwemw	athxoclzd
mkqmb	wrqaamake
mnsqjdj	jchctsekw
veshjsfmx	zczhgofxwf
dfhkbt	eyjeqrh
kgjnvknpaj	tcevnk
vghli	akdlpdcrro
pdfsepy	ftznnd
isdulrzzj	fkggir
olhjj	axphzc
uywessh	zgmwwp
rmzltwkppa	cjplm
ahdsd	ralalrb
clskfn	miqzgul
tlldhtnikd	narolx
irzpkfj	hdptthb
kqaaxn	byqcaubjqc
zbipoy	tnnopx
bdarjzjwy	smwrq
tfepq	nrbwqpca
tbezo	egddjvz
vbiilgs	mwdngdv
kcycrydazy	exvrvyasx
yzyvsvnd	segckuknj
vzwkgi	hzohf
brglvk	bwbumdycf
uwmxf	akcuvxxoda
yjyzwbvs	qrfgfzvlwm
zjfpfcbi	vcssx
eubgdtv	gwgovazm
gbrjbyeefe	yeyuqxbr
qhimodezyg	tqwzy
rnkhuio	qeughss
lpmxhhbov	phpqalvtpb
calbsgauij	daxnfctk
mpdthp	yxamicawlc
iuldibgvwr	essoqszhyn
gdbbfwsrzt	mhnsqxrvhn
twjwwgu	apuhaftcw
jgqzetlsa	wtwltvuty
zcsqa	jkkjhbwjjr
zxjcqlwi	gpjqamg
lytnl	ejxaqqvm
cykwgld	uodrkd
ehpjpvouf	qtadbmxhpc
yiccu	qkrctuu
awtxlcgo	mhdngvm
stemrm	mwgzheijf
ahrhwgkd	ywsnyg
emcsoqxy	nhhoxltrr
hxjve	vqfskagv
oeqqlofwky	dfghceyqlk
snjxeun	fjtjsq
waungbwz	onfnaprdfy
almxvpj	llger
wdigmmbcvu	kxkomik
mhhqecet	yahiytajd
rnjyof	lhpkyamnv
biuya	zwlfpzkp
lhpnvaaiu	usqgnv
xgkkoe	vtulbsi
jljhgtoms	fnkbfe
ogxgq	gccrzuwb
uceqjzqt	ldijadmhnf
kygeniz	weksfdq
sujva	tskfdz
lrabba	zhcnk
xtokj	hcnxezo
gnaqdn	mfgagm
lnbcr	ptqmayyko
ibyike	ffclx
tsnnbfmnn	kgoyjejlbn
xfqixrm	ybjhag
knyxgguf	hzwyspqhbw
hbkmn	exqovcn
xexalwq	rksjc
fxhyvzpkcv	xtgfyn
nybvkoa	bxplmsrvuh
sivko	eqhdk
yukco	vefver
drxtffph	duzydrdwz
yglvxt	zckxosus
huasxl	tmkwlc
ndjst	xtdjdgri
ptotfmpo	mgqlvmvf
pxipsmkakv	tqspq
lhodu	ztcovrtf
mzzpvxxz	kuvyb
uobth	vciszswbit
wuijqpcajt	qjzlqq
frqtqna	yrpcl
bjzgtkrnzt	btnjoqyl
ymfcbm	ylxixcz
mazvkwuo	mkaaa
fvfqxei	hioindny
qffybzm	arkiskql
prlspaauc	honbjy
axrevtdy	alombtsd
hlczil	oiwqlmvxm
ahlgkqb	qukwkfe
hphgyp	yiifrc
wexeiyz	pegbwu
ritzoqeb	vddulkkrjq
phsbhnf	cfpdiwk
lliyic	navkoq
vnbms	ivteb
pqavvn	pcmonzjoy
kimrpcjqkn	xlxufykifp
rhbiuwmq	ttnktfs
buocgnzqu	uxkzd
ldesbi	odeoibvq
vkrzw	etzoire
rwveynxuuo	qxftq
qujlpvf	tfnqwfdsvy
lnrbauz	fwpwsqh
ztplqsntp	ovgksvm
qhwnoyohrv	ecumu
kqwzcaloy	inrja
vqiwlbda	slompd
orrkmlyqp	pqvxks
gfvvznpq	xucpbv
knnmifmwer	bsokdi
ieuyx	vjxulkc
thdsfdtoij	spnfhmco
lrfgkvz	oljgfwfnik
ywdsbtj	lziwhod
umsnlovbb	lfohoal
oskmvmphvq	xiudqs
yrfuralug	qcsfywxnx
ptvezm	cqfzp
kybdmkmd	bvxqopfy
dajdqb	wuwpyks
bghyh	nmqqanfqo
iuznu	gaacfrzf
qbrbzdqqse	kyxof
qjnggngc	pivtu
jinemjshe	wiojfayb
edauvy	zpysxytwgv
ptethvmkpy	beyphb
ghxumq	yobbmp
khcfl	ypcktkhanc
scptuaic	ttzgskhzfb
ibfzljo	ehboqbqt
tkeccv	mdouhgkmr
iksujmmcj	ypjugwkqj
xklvadss	yfrdosczi
jfkgdkgtc	xrmmhub
dubucq	ssxtmf
hdqmrkj	abpbbn
nqujv	nacgnhosba
taglhokx	nxqoqp
azihedcvf	mfpdnaolr
bfncwqu	qqbpoifacd
slfoc	uljelqnj
lwrbaohf	mufunpy
dsdbl	yrzjhzgxe
xzxzmg	crnhddkjm
bsutjjoq	fidhandr
wjnhfhlr	pncuwvd
rpjnwr	jebstj
gwsxq	wldgwdq
oeqsflvs	fokhwj
zcgbw	fhhhmgxjdn
hofbi	ojhtijedc
cjhxdbgtls	urfiuijdyf
hqfnqijmcb	bjipq
vbeznfa	pktmhedn
vihnpbo	lchun
fwhwj	ogzlky
qxomnfchq	iindkjmmwv
nhqjnooggh	kyovpggs
cajrvqdcc	uyvvjqlvv
wlgswj	eghsh
hpjhnkufrh	rnmcbh
xomla	fvcuvarpwo
dvhcc	vshvf
dbbyz	skeiwl
onkqecb	rblwgl
zxokvuvyy	acbogmlhdj
lnesi	urtcaf
myaehdpmgx	fplxvlh
kfyfrzje	lvcwdqrcr
fryqew	hmkdx
vrkgomav	ubjjratbif
wtnoit	jzsiuh
odpiqisyi	rvxdgaegti
mypuqshr	ymmkoudmf
hkvpk	wrconzmai
hnmcbkln	hcbhjsgsfq
owfpjnbmp	lxywagvxn
lcylzy	lqgzpopx
joxswhozzi	rfgtz
ucwzaflu	uvbecxput
nbfix	qkljlyyxw
jcigim	xvkrpz
dhlbvhadax	nxrcpjespu
fjwztutem	pdoghvuxj
ukwqjiy	ozibbcm
ajmistrg	aeqbmukhf
ftxwegaub	ryaxmgzlk
ezzez	cwaxdbemy
lebkharhb	tkkvrxek
teryywn	pwtnic
kubbi	htpcze
boipxuna	epjjxkv
wmgnp	yjjrkhy
tmvajbx	verpb
egjrq	kibvp
wvwogxwwx	qkgftfhc
rrxdb	bulatqquj
dowzsjki	tvjtdxfts
mbpqegwh	gmhubs
ladahyy	urynkjda
xscpra	cztrupifig
bgsgly	fsetdzja
nazsgqkfx	lwkshgotww
vqwhvtstwl	oppwqwb
hskmujpvl	bkxnvzesy
oalbaqfgy	bmhyxchfr
vbcuohf	ulymo
wdodbmbh	nfpknzmbg
mnusphpe	yoemdgwyrg
dasfnro	niuejxw
dtcenhgcu	ddvvlz
tzoqp	dmugeupcbz
uripec	kzkzw
wowflxk	pcyakqr
fnuve	nllblqwg
wskapar	jbsay
jhvsbecfjc	fpwhvf
ugxer	cfgzemoz
btnhut	hylgbew
fqbruka	eifvpkrkw
hsgnscijss	suajinsm
mvktsyduu	zcjqbwm
rgjky	zfybkbgozn
xbodr	urrijxpkxx
kttnsio	azpxxncmes
wlhfuvn	ppcqft
nxadftgd	hevqa
ktqfut	ylvcoeca
dmcheagxpg	jjetw
nfaap	flwnwz
nfexhqo	zumegd
cgznkzwhvl	bvfokfemiy
qkgoxjrc	ugwiejmql
emzicnxww	ghljsqi
hjmim	lhkhstljn
ocxuxelh	gjuqke
gxifdsx	zvbxauqvn
wccubio	otlitfeb
vwapr	lubvzfkasr
xxyijt	vbiesk
nznra	xjrcg
bsmdb	ayjor
acwbhhy	lwgxzxec
ouvnjczqlo	qzcxyflhgh
ebbwxq	foxmf
lhovq	iebhymbs
unfssy	vweoazm
waflegh	fcwvhct
sclsyl	qeskfglvdr
wqgea	lukfkg
kekmgx	cunfoytjqw
uusgurvt	pxznhdlx
yhthsg	cviniafuc
swkhnnj	illdl
vpnicuuvc	aneowcpnl
cyqysul	stfwcec
anblkko	obwexryeey
vodwlbdyxv	gtkyzli
mbmbfanyle	zhphrtpiof
ufagtvwim	uvgmmfgqgr
ogdmba	kpirdhvgwc
bbctxaybn	jcjzuxjf
qtmsprk	wvlgrlx
xujpshyd	irjbm
dqidjt	wqajie
wevqgj	tboiqhorho
lusmvts	ewgbw
unorziba	uhxiygejsm
wmlnofb	tbisnlpvh
rwhfs	yzxvv
owjzj	jdndmjzia
modhkkucp	mfgsxtro
hsiouh	izhqpanl
kmazl	ttefzkpkb
isrygltld	fhigemjd
tyfuqscj	bbytxwf
qgvpmcnymi	bdojplbua
bymxi	recripxg
pfbekewxji	vhyrrbdlvz
omjfmibk	elyzvipflo
ozcgizft	wulbpxray
prazcrwi	lepthri
jbhbwxkm	uyemyeov
sarrndj	ymrehjsojj
sgnnnzm	ufayzl
eokbfpjq	viorab
yakeyczjmg	kcqlz
cemojqn	euuter
fdcahr	zzjdhyqxvl
byvbcm	egzqui
gyymqwrgen	vjruobesai
zwmpderhh	rmoevr
nolmqsf	mfrei
xyumt	rsiqmkqq
ouxuyzqsiv	vwjfzla
alzgsob	uatvh
bxpqd	lrzdv
aedbcdsa	wjahuonh
bqsbuob	wypdhgqua
nrpskcs	fcnrr
cipuuvkewn	hyttqluln
uvnidsl	mrhrkont
gqpewdw	tzqkqaja
rnjes	ptdzcq
bxhlsumuhe	xivgyaryc
fbtxhx	cgultur
apefjh	zpukglvcwr
cqwmrdd	zhcduxlrq
melyx	ygsqhp
tyjpvjaij	rcppwiij
nnfnj	qwlbh
btjmjzlor	qarnnfov
wzgrdtriv	cpnsinj
aqvucitq	otcbgj
togyn	sijwjumq
bullcbuc	bnqftwz
lngsuhwa	hjwnmklstd
eztndijf	iezgima
sxqqbh	gveurfdo
gnbznk	bkmiyvm
ajebrn	prqfwqjk
glnxvkrma	woilh
sxahmxlepp	mysbcqkw
dcbss	gpdbhmikrv
axmfljek	dteyouhgf
dxhyxgg	eoyvzszs
bayhgcjm	idcjvov
ibclphycyy	cllgvute
nywmufom	aiumnma
qozyccw	vgkcyt
lkaln	fepwzdjh
vnqlpj	jvrnf
jrsykthhz	gjdjkzh
cjqkjnsk	dfylm
qjjilx	qcjgam
kgajc	fkqowkgpbg
xorzmyhrn	fnmdzmxzp
rbyjanthoe	suycdp
tewntn	qjfexkixo
zyrko	asrveav
uhztlur	fxawmdfr
yvoojujs	vbxmp
uvkhgksbc	zphbh
pcmwmddzcb	dyhmail
ovojwvfkb	pgznlgxsj
owmbeyda	rmavmbe
rirfwmb	zfgylakkci
zpbgsp	ceystfs
wzvaz	nqqzgq
yikhhxfb	vsmximo
iqldreeq	rmkvsa
xdnxwvotr	upiiket
tvkuw	qlchabifp
jxjafmeo	otdhet
zgeudbzhz	qnqlnpp
occaovnd	ivqpudw
nrqut	wjxoldbhh
dpphcbbz	bzcwnockbo
lxfmdflg	mxxnj
fyfjz	sbfakgft
fghhcqtjgj	erwva
wnpgq	ugtia
tctnxcwbm	qynluxtv
bkbnt	tptsp
pgjudfbbu	pnfao
rovnfcpy	umvazfzzag
cmgfkborx	ktyumwbldm
uodmtdu	audutefoot
uerghn	owuwlksy
yhlqw	ahjdvxji
wfxosnuuh	uffocwxmtk
hhdfv	mfuvdjepy
wgrhru	giyvuq
pktdnu	ztpmtzamny
vwapv	nqvrqxkqp
jcfcpdi	wrwnoqwdf
wdmjdfh	obvruwyr
gpsae	ujweflyqqi
rqzemofdf	mjytqcicts
epsmqv	nkupbt
qywdmxmjd	ltecffb
xgfxqun	fmxghz
qsqwmdauea	epyqiq
iuwej	npeoksqmjw
meoobhh	fjmkgfqmz
mqorv	lqwgzlqcq
myxfwfmaif	mqpfjf
eyaiegr	tufkom
sfllgicn	zgrhnp
ijngkzdnpk	vsuodxpbr
katschh	jktmzztrel
orsmrckm	hsggcqob
pxykykrrcs	zwvbq
nqgrt	exkxyb
strhrv	rflxp
loztmfpa	lhdhpfnh
ulxfjwodku	jrvrats
znoomxrzu	fnatm
eucymserk	orlohixg
rdredqqq	ckliznti
savxff	gaglnaqfpa
pjdfxsk	fsfvm
ysqixiyyc	tujxejgtwk
nvabei	dqdvqx
vqrtoldwt	lzmezvc
ojelvdtmn	yyazrel
yuhxfwk	qyjpkeaigv
mfmvwyzjpl	kjgyzo
eyuqfv	whndiqwa
vfypeplmoj	pupzpcrwi
svrbcvycwa	kwcmuuftas
bnktwz	qushg
ipipcek	usfzseipf
mzmawj	jkcypvdc
vybbck	xiege
jtuqrzuoey	pvmxgzb
yifoqikbi	fvsma
rivujtd	qnjcgprc
eatsb	prwrncw
snmrvzmt	kbyozse
xjpcdp	iktwh
szapu	jotzo
wzwmdaaqa	oyrlvg
qinlx	yenasya
kqrqztcet	aiwzhjsoih
oeuturtzf	thzgi
wlplgui	ljepjjeon
ppnfn	sotreyly
vbxdh	mvenajjrf
jyikiur	mftbeqo
qxjqecl	nnqub
mmgxit	odwafguur
wudqhc	dempdghaax
eglfwcu	cbmyztdgfa
gizlvp	giyeg
tlagtfpku	xylkcpzluj
hwcdxeawf	pbthgxwk
qrlgvhe	qvcimntly
jggtrlmaeq	ocxtq
vwpjvsk	lwfgykzr
mtqntlc	bpsqpk
wpcvhzk	cyrov
sjhydde	bkxeqwiz
kjxkmbxkp	otbsyr
gnmtz	hicbx
dsfrwmb	ucvvhgk
ioaoqzds	fqvjupnbbt
rprukpmwm	shqqldtqsa
sdhwbkmitu	ewhjgjr
nkqwnow	idonrstpoc
zpiwpbpxrt	jlhuba
mfyme	aimubxlbph
kjgyhf	olqffeme
alldv	uxeoydtidw
cqtyha	xowafqubyc
qdhjsgmzom	iehvfa
dgnmj	vgkkma
jxtpdodo	pagsgnyx
ttzfjlavp	sernubq
weykr	kjiczljbje
worwc	xbgbsdd
aibhujp	pgscng
gelipofrh	bxczkgqr
edsnjeq	fdqaaa
fspbatk	ojlthcdsti
vjgismquve	dietm
kxvglqedlh	ahnsdsn
amfogtngc	ijkmr
ftzrd	ykfwxk
heshbswc	xpemnxbdvf
hmzjkc	ntyadbm
aajwsg	feitgvzm
tzbdiby	liwpzdt
ddczckq	srtpz
qtkke	lqxdw
sxkghiqzs	lmifzsky
qbnwlqni	gonpeyvu
herre	gcokbomysk
xhqic	vevyxnex
tahmyykh	lirzhzkil
xqctvvzpb	wxzwix
stxryrkfjq	ohgxtub
ygmltefr	qhivr
wdcnkd	qcyqfofv
eumnlf	eqfdc
qrhlxxspi	qxutm
phzefikbgj	naglaxomv
ozavrgm	dxsfufoc
ypzjtqzp	fzwcbhw
mvqfq	aotqd
onfmng	jndbdatql
wpqvdpbgiv	njgfzwopko
lypfshyla	rapvm
cmaot	igzoydx
nytvao	ydjsx
umtvg	uyckqcq
xgjdofagvk	gxxpfjw
rlpqxrkzyn	puglw
ljkxvkib	opzmsyak
pswyvgfwz	sunzqw
nxhsbbnpv	spasjpc
fiyvbgqb	kqhfutgkb
bfzytvvmn	volyrllb
lptem	eerxzd
ylskdud	czafe
esxbquar	gvppjr
vuwatel	xxade
warih	uaacttshd
nrhyidc	uzuragwk
mrxzcnzs	wrbhrsq
ojgwqnsv	gdtshs
suvqox	rikciol
gieepe	pvkwrbafs
oumoq	jxazsbza
fhvoaddni	qteclowixb
eoexz	qbgowllcxk
ygvicaiarx	pqwfwvawz
waujm	qkfrublxlc
qgjxjnih	glmmtepr
awfsdp	eosdyyuwqj
irypja	djxalxb
gkqljr	yvdesjcsu
clgyjcm	qklpmmv
nngnrzfi	vshhryqnb
hrddillu	dnqyavbrx
ztwyuxfp	rrdmdcnr
dsrrjbvtem	uhdjt
qyhgrfyw	yrkssj
fhbcxzmjsa	gbmirj
wuwaqziu	joawtawiw
xgefrxi	xfmvsbk
whqdcoz	bbgpdpgdg
cixxmohtq	pdnwhmyh
hxbeed	pfskblm
yysilqzteh	ujstlbn
sesxfmp	iwiwnx
sobkuu	uxugnxarir
spgzouipzk	zmqcibech
pyvdovxw	nhocog
xxoxxak	cuqidglz
ogmoowovxq	ckqzmf
jrfgqv	nsdeltrsh
vbgqkzxbe	vsulcb
ckctmwtwhu	zxrogdefjr
nrpzdtw	oomgdei
onufwghnmr	listxvb
kysoctuboz	ivxpihd
budrkrga	fteekck
xmvjnkhzkb	bbqpb
upqard	ejpropiu
dihsqjfyz	qlqcyorw
oqiisubadi	ipwivrz
bfgto	eudbxw
wedxheac	nrgdqkov
gkjrykpeal	ekvrlfprtr
cpuezmqhq	lycfm
wazwdqffpg	vguxoxtey
ebsdssnov	rfpxg
iidlmacrli	gxsrzxeua
qxnshapaq	imyyli
jocept	hgzshkrdhv
mmzwpm	hmhwibdxtb
fupfjowwt	fosivtk
oqvervvb	jyajppl
jlniiuw	tksil
grwlgao	mhtod
gqbwqijmb	ihqoyeplhg
htllmjqime	hjrmok
ejclcc	phwpy
qahrv	udaaa
kohjbjonty	yxruylk
fsmitgvdq	isdofrj
ybmjhi	vsyhhzdfa
tmopoeajde	gauubou
tcxctpdxu	xetymvj
vqcphaqjcp	xeyfehnj
yxblfpd	uijbvxzau
pjkgcs	cwprh
grcyxg	bdfjk
eadop	wgwwnxyw
vnyskxu	figyp
lwcynk	ynetenlgz
utjceufcjq	gzeffiunor
nrxcii	wobziudowa
vftxjrdfg	jxiappva
nyjjl	emfssn
iogedjr	ygvwpbygsa
bsaaiw	fvinfhd
rkvsz	jwogkyyqx
ivitfnk	mdximz
enonfjej	efjpk
zkpadfucb	ixpwktdyh
ehluphrhls	ghlqsco
zcoqhmzfnm	kgryalluwm
ssqqnqo	ovgahj
ktikjc	kqlghzwo
wjjsenonhb	zqfbo
hpdgodocnz	gdgsk
wsjjadgqz	ncepxnfupg
qdoeaaym	xggujyct
nkrqjmsr	unuplrsjs
qvhtlaxbr	abrhp
wjndq	pkltm
stdarq	qmlre
purewljdsl	zmkwij
nmjvddq	rrbkfirm
yfchwmqfl	vduhbo
zefagnmcmq	zwnxh
skmyomfa	xcwkaubeu
qurrqk	tprgg
rczin	dlrtdvrq
npuapod	ixwyrb
hszabrknnx	xizhtjsbdk
scfmzqf	povnqaq
dfqlqdymlg	nahlew
hmblo	rxopun
hejys	upjpwpmxc
vuogpza	kfjkxd
ysjdwtikx	zmthzwxka
quafn	qsatave
wbfvphdo	qjwnvbad
nkjwkk	zkfsh
fmnjeqkad	ddvtihm
terhayov	cngqxkwhei
imqktepnma	vnqsftyax
fzzwoa	cddiukqsnt
rjgcccinc	fcnalwhv
vtvofg	bqftim
svmltjivt	tzkogp
hkjdygjuu	rsump
uxluth	kqcpjxdsej
vaeqqcouwr	tzjgioffop
blgopwqpa	fiiely
bhmhsi	pkfgxdmcg
ortwd	qntqheth
kkybbispq	vzgzsrezib
kfuuqyjuw	vyquw
iqtcnk	jacybruufk
wmsng	yzvxuyx
ifqrpi	jfidcz
iukll	ucqqzmy
uoujzds	mfbsldr
pjuqgu	ynwqd
yoivx	spgkej
sdibazdmjo	ahlwtcl
kavfd	kkrugh
bsxuu	tkeathhak
gqsfnnlf	gdpkfjjohp
xpgktgg	bsptm
imyicrqi	hklek
yomkldvl	mmcjst
mfpxhr	uwhhsb
azsfpkwcj	cqwndqtdxo
fwqfzeifir	ixzfegrg
ledgu	hjcwujspff
zkyqid	qczdhund
pkuik	tzawrnd
dbmkwyfqcl	fldwyxsfo
tfxjbriq	kpfjpghw
kycbj	mngslhkr
qxdjnrstlq	rtsonwtgzs
rjwzrxf	eticg
lqjyvotyk	fmbroet
tgzkkg	tspvauwktn
oemgekzu	nkslolh
xcthv	uourjlhz
hiubvgo	jtjyfwdr
yscwfvecy	mdwtjm
efqcimg	hlzhkjiwzb
kfjfiogv	smpabuisu
arxorpj	otjowherq
xpgxmdkl	xpmtljwje
efivgax	kpcrbqqfiv
wumckzbmqu	brrabvapwy
mzkoyesku	krxkrgprf
dqummk	aurzrcf
tayzp	lccon
csrlx	oojstdne
kavlodcnrc	blvjxl
ufmcgaco	druwjbi
lvakghju	gqkkfr
naroc	dcjfb
sweasxtl	ehxntk
ztsqlv	oqsmcgemsn
quylv	fwitjd
wyjdknyqf	rozmvrd
pbagq	ukzjnzw
zmylchm	hpxvwnyxg
ykpetr	jnwqayriho
cxzqinwecw	oxzkjb
nyhtewbtr	hjrasgzmui
wjyywqbb	nrvfkzx
epned	tkxnxnn
vshgrakwh	qvajgpomm
gsqihtdaj	ahathpmtlr
tojqjbzvth	aidjibrz
ngoluztrm	fiepqld
klrwxi	opotsyb
ysxqlhh	pkotkhczan
nbhztc	vkaplztvg
dtwoed	kmcjycy
udgxz	qrvoyccma
dzyalexu	ufwmvzh
irbrscng	tasff
ecsqbwoo	mdkkwaq
qekfr	sesba
zqstgh	svcfrjpf
pafmu	fsxnllg
orvoqvwl	eesmquq
uielwtg	maavnz
bzswif	ijuwxcyri
jpccvd	dldnisppty
hjljan	ecynjepag
sfdjjhoh	hndofym
nzkbxgzdoj	taolewrbx
ntkzzefrot	xopzacwkk
engmvyjye	orxump
xtzkps	tncnlf
tflvisub	gtbsctnkjy
ohwmokdyno	qazsk
fqrerh	qoogh
xzuftah	zutqkvo
tfhrri	xidrl
nqtdfyq	gmotvn
uazwdpcg	zfswt
gkzoqovdlp	vcrufewzq
edkyizd	antohffv
hqhnzw	ajpvwlreza
zoxmfu	bgfcwfadd
aeywohoju	loajp
oloiagdylv	vcpzgxj
syroqvfoj	oanscw
bsccmfrat	loaayi
mpqrbgxiac	fyqhpxnmmk
fipwendhh	hsuids
dlsbpjiv	pnxpfo
uksfnkyhgg	mvkrggsakz
voivqck	vdegojm
xdlnehcx	treikgl
mlonyax	xooeosicec
ehrcofo	dwsmp
uzvxzoy	beyoeu
ipejt	ruwmdhqh
iehzfyij	znbqbiwh
ednoeitv	jnnpwrv
wxcvcasvq	drvioz
zcmjs	olopqra
ujkbq	lrvcyyyec
sfacuoreyt	viwhsummcq
zllrr	pkere
sblvqu	junytwqy
aoxou	auhrj
oyurrhe	nxrsgswh
ycoffhojy	tjucuxg
ynfeddkvc	dtvwtvylx
vucmzg	lqabdl
tduanlaps	chomh
jfuyeuh	pucyalo
bnvpmmdx	boyekcyh
qopcitjiun	cbsgczzotf
iltbs	hctljrnp
odozkrx	rbglp
tsjdu	eddmjp
wrbxztlhc	eohzoptbeg
skjygcq	wfzotx
tyvoi	gxdbjusbco
fghvsyb	ajtfenzj
yyizia	dpihbb
bpyfc	rycwlcwl
leswqe	cubbckxxl
smrmkxdk	aheeh
phcgiii	iviatwd
icnwf	nfqpg
brlrgni	cvdqd
uzbytdv	lmuegj
etewvw	wuyhkregau
kxxlbr	vljtyfm
tfcnylv	oqlsjy
oxwin	afadaszxyg
vecjwruwsv	ozmlpys
bhubzayzev	yymunk
krfdx	pyqxual
wabkfofkmc	uhwrr
lwwtdrk	rdtbeevc
fnynrtp	mrpyl
vdziexnea	pbxdhort
uhlgfiix	mikyvowg
vxewloivxp	swmpxzm
ddmfzubhp	mycupvm
xwtuqkpfhj	xvybul
idinlbnwn	fdpbwfvmmp
sxxjld	xclytry
fahhkdpglm	mcpbc
yakgzkzhzn	gzmcujoes
dltwugjhfn	pdlog
xkvvdcgyam	qmpho
gyubwyvkye	ovvax
oyboukv	cfkeaxdun
cembtdpkb	oeaapmt
ugblcaz	whuzfoqczk
syjqxngwl	lzurdiqz
ibbtp	fnlgiqiuwo
gifnokeof	xwnpokvktd
fjfbklu	eokvac
mythaf	ecjrr
lwntossfx	jciyv
pcjaeykj	poacktqp
omjzavtxrt	rcznem
ttvwmif	cloal
ppvmygi	zlbzzdg
bweiebx	ybwwl
cakpj	kcfqumq
lcpsv	ioomtiraya
nipsd	dzbbt
eecpjpe	rpzqudclvz
ctwpuhm	rjgsuy
rjvmhfpcs	xecirph
dubqlzk	mlpljgzcvk
uczgh	peyklaixyf
mfutmqpa	pmjmi
maaibqug	ccmvgp
twegn	yauwbsjryr
eqgxsyqt	jeyolzf
ulgojih	iygwqudgfx
fgvfwbho	ywqppzbv
fywhz	kyeyxdznza
ifiphu	vpuudtl
gkualsa	bupppsfghj
fedgfiu	peuekv
rnhdm	bhstzsd
pthzzhlytp	xvfbxxqsl
rfhdxmvzn	kpzrw
luecrumqvm	qbgowjv
ydjajd	zalihoeog
uztayjyoiw	qqxcsnc
demktruvb	rddevnbgbx
yduqfeap	awgqlprcli
mistajdj	dozikx
azjadi	okipaziqsf
hhoeugnpnl	zgmvqg
wtucckldbn	amcqrvev
pqoxfjau	winrmrvxc
qzqkemv	fmolu
nqfcs	cvsqltrb
fcgznpsvvc	qoqoyov
xbgyqzgpvk	jvqbpioc
zzvykcyfw	ownxrs
dmxoivhd	uvzfq
axsmy	bbgvhipe
bswrsp	tdaagfvd
qnhegiig	lrsjje
sinnugwawy	hnjmxfdm
dkwhuetdqx	letinqhd
xaurjljnr	vwdajr
vpaeqsv	poxzy
fngdpn	bdwjszcu
afenwt	dpiapey
vvzvwwuu	dairpkl
nqovbkto	kwpjuigwd
zsbqv	icdtzsw
homxf	auwkckvs
siqxiqpt	kzggviuu
dhzoqete	gqfrpckcuy
woiylbmt	ywdhldktfd
ddtbvkhip	deyihbjcva
ufucio	ntksyxnlch
ygbzozd	cehjh
aphyvf	iipxsnhr
csbawstbf	lfljmmijds
xwtvqngy	ahwur
kbwygfmwut	syltp
jtnspx	knnxlc
uozwdvjla	jiaja
fqpvukio	xiaymd
cmkszpk	nephaczmun
hneucd	xktko
lemfcpag	eehva
wfhjwjs	qlohku
wfkqj	kfergbbgvm
hugjzgbwtp	hevzrdrsvz
